EnvironmentalDNA	EnvironmentalDNA
GenomicDNA	GenomicDNA
eDNA	EnvironmentalDNA
1 ALIZARIN	Unknown
1 IN ALIZARIN	Unknown
1 caud vert	Unknown
1 microslide	Microslide
1 piece eggshell	Eggs
1 piece eggshell, phal small bird	Eggs
1 vert	Unknown
1 worn thoracic vert	Unknown
1 x SKULL & SPIRIT	Unknown
1% vol:vol	Unknown
10 phalanges	Unknown
10% For & SW	Unknown
10% Formalin	Unknown
10% Formalin?	Unknown
10% formalin	Unknown
100 Ethanol	Spirit
100% EOH	Spirit
100% ETHANOL	Spirit
100% ETOH	Spirit
100% EtOH	Spirit
100% Ethanol	Spirit
100% Ethanol ?	Spirit
100% Formalin	Spirit
100% ethanol	Spirit
100% ethanol ?	Spirit
100% etoh	Spirit
100%ETOH	Spirit
100%ETOH?	Spirit
100%Ethanol	Spirit
12 microslides	Microslide
12 pt ribs	Bone
1884),Zella beddomei (Petterd	Unknown
1pL1pR cor, 1pL tmt, 4pL2pR ulna, 1L scap, 1pR cmc, 1dL red, 1 ant stern, 1R ramus mand, 2 cerv vert	Unknown
1st vert synsacrum	Unknown
2 EGGS	Eggs
2 IN ALIZARIN	Unknown
2 IN ALIZARIN ID not known	Unknown
2 MII.1	Unknown
2 and a pt vert	Unknown
2 caudal vert	Unknown
2 fibula	Bone
2 frags skull	Skull
2 mand tips	Unknown
2 manus phal	Unknown
2 metatarsal	Unknown
2 microslides	Microslide
2 pt L cor	Unknown
2 pt fibulae	Unknown
2 pt thor vert	Unknown
2 pts cranium	Unknown
2 rib, 1 vert frag	Unknown
2 ungual phal	Unknown
2 unguals	Unknown
2% formalin, roots included	Unknown
21 microslides	Microslide
2L fused radius+ulna+carpometacarpus	Unknown
2XCLEARED/STAINED	Unknown
2d tmt	Unknown
2d tt	Unknown
3 EGGS	Eggs
3 frags pelvis	Unknown
3 frags vert	Unknown
3 microslides	Microslide
3 pedal phal, 1 metatarsal	Unknown
3 phalanges	Unknown
3 pt ribs	Unknown
3 unguals	Unknown
3 vertebrae	Unknown
33 microslides	Microslide
3R cmc, 2pL 1dL tmt, 1 dL tib	Unknown
3d cmc	Unknown
4 EGGS	Eggs
4 IN ALIZARIN	Unknown
4 X METAMORPHS	Unknown
4 caudal vert	Unknown
4 frags vert	Unknown
4 microslides	Microslide
4 phal (II.1, II or IV ungual, II.1, IV.2)	Unknown
4th cerv vert	Unknown
5 Embryo's	Unknown
5 IN ALIZARIN	Unknown
5 microslides	Microslide
5 phalanges, 2 frags d tmt	Unknown
5 unguals	Unknown
5% Formalin	Unknown
5% buffered formaldehyde	Unknown
50 % alcohol 10 % lactic acid	Unknown
6 IN ALIZARIN ID not known	Unknown
6 microslides	Microslide
6 phalanges	Unknown
6 rib frags	Unknown
60% alcohol	Spirit
7 microslides	Microslide
70% & 100% Ethanol	Spirit
70% ETHANOL	Spirit
70% Ethanol	Spirit
70% Ethanol&100% Ethanol	Spirit
70% Ethanol/100% Ethanol	Spirit
70% Ethanol?	Spirit
70% alcohol	Spirit
70% alcohol + 10% glycerol	Spirit
70% and 100% Ethanol	Spirit
70% ethanol	Spirit
70%/100% Ethanol	Spirit
70%/100% ethanol	Spirit
75 % Ethanol	Spirit
75% ETHANOL	Spirit
75% ETOH	Spirit
75% Ethanol	Spirit
75% Ethanol/ 100% Ethanol	Spirit
75% Special Alchol	Spirit
75% Special Alcohol	Spirit
75% Special Alcohol (Methanol/Ethanol)	Spirit
75% ethanol	Spirit
75% ethanol; 100% ethanol for DNA	Spirit
75% ethanol?	Spirit
75% special methanol	Spirit
75%Ethanol	Spirit
8 microslides	Microslide
8 unguals	Unknown
8 vert, 2 phal	Unknown
80% Ethanol	Spirit
80% alcohol	Spirit
80% alcohol & BAAE	Spirit
80% ethanol	Spirit
9 rib frags, 1 scapulocoracoid	Spirit
90% Ethanol	Spirit
90% alcohol	Spirit
95% EtOH	Spirit
95% Ethanol	Spirit
95% ethanol	Spirit
96% Ethanol/RNA Later	Spirit
96% ethanol	Spirit
?	Unknown
? HYBRID	Unknown
? Hum	Spirit
?100% Ethanol	Spirit
?70% Ethanol	Spirit
?75% Ethanol	Spirit
?HYBRID	Unknown
?pt ethmoid	Unknown
?pterygoid	Unknown
?radius	Unknown
A = ALIZARIN	Unknown
A/B buffer	Unknown
AGA	Unknown
ALIZ SKULL/SPIRIT	Unknown
ALIZARIN SKELETON	Skeleton
ALIZARINx2	Unknown
AT.41.3 1F	Unknown
AT.57.1 5F	Unknown
AUX/TYPE	Unknown
Aborted foetus	Foetus
Accession	Unknown
Accessory documentation - 1	Unknown
Accessory documentation - 1; Sheet - 1	Sheet
Accessory documentation - 2; Sheet - 1	Sheet
Acetate	Acetate
Adrenal, Heart, Kidney, Spleen	Tissue
Adrenal, Kidney, Pancreas, Spleen	Tissue
Adrenal, Kidney, Spleen	Tissue
Alcohol	Spirit
Alcohol Preserved Tissue	Spirit
Alcohol preserved tissue	Spirit
Alcohol, PCR suitable	Spirit
Alochol	Spirit
Ambergris	Unknown
Ammonia 5%	Unknown
Amniotic float	Unknown
Amniotic fluid	Unknown
Antler, horn	Unknown
Antler, horn, skull	Unknown
Artwork	Unknown
Associated reared adult	Unknown
Australia	Unknown
BROWN FORM	Unknown
Baculum	Unknown
Baculum; Formalin & Alcohol	Spirit
Baleen	Unknown
Baleen	Unknown
Baleen; Formalin & Alcohol	Spirit
Baleen; Photo	Unknown
Bark - 1	Unknown
Bin	Unknown
Blood	Blood
Blubber	Tissue
Blubber, Skin	Tissue
Blubber; Formalin & Alcohol	Tissue
Body, half of	Unknown
Body, whole	Unknown
Bone, ear	Bone
Bouin's fluid	Unknown
Box - 1	Boxed
Box - 1; Photograph - 1; Spirit - 1	Boxed
Boxed algae - 1	Boxed
Boxed algae - 1; Microscope slide - 1	Boxed
Boxed algae - 1; Sheet - 2	Boxed
Boxed algae - 2	Boxed
Boxed fungi	Boxed
Boxed fungi - 1	Boxed
Boxed fungi - 2	Boxed
Brain	Brain
Buccal swab	Unknown
C	Unknown
C (IP)(WO)	Unknown
C&D	Unknown
C&S, Dry 31	Unknown
C&S, skel Dry 30 35	Unknown
C&S, skel Dry 35	Unknown
C&S, skelDry 30 & 35	Unknown
C&S, skeleton Dry 31	Unknown
C(FS)(IP)(WO)	Unknown
C(FS)(IW)	Unknown
C(ID)	Unknown
C(IP)	Unknown
C(IP)(IS)	Unknown
C(IP)(WO)	Unknown
C(IP)WO)	Unknown
C(IS)	Unknown
C(IS)(IW)	Unknown
C(ISW)	Unknown
C(IW)	Unknown
C(MS)	Unknown
C(MS)(IP)	Unknown
C(SW)	Unknown
C(WO)	Unknown
C,P	Unknown
CARAPACE	Unknown
CARAPACE&PLASTRON	Unknown
CARAPACE/PLASTRON	Unknown
CAST	Unknown
CAST & SPIRIT	Unknown
CAST ONLY	Unknown
CD	Unknown
CLEARED	Unknown
CLEARED & STAINED	Unknown
CO	Unknown
CO(IP)(WO)	Unknown
CO(WO)	Unknown
CP(WO)	Unknown
CW	Unknown
CW(WO)	Unknown
CWO	Unknown
CW[W]	Unknown
C[C]	Unknown
C[W]	Unknown
Carapace	Unknown
Carapace & skeletal	Skeleton
Carapace scutes	Unknown
Carcass	Unknown
Carcass; Formalin & Alcohol	Unknown
Card	Unknown
Carpological	Unknown
Carpological - 1	Unknown
Carpological - 1; Digital image (high resolution) - 1	Digitized
Carpological - 1; Digital image (high resolution) - 2	Digitized
Carpological - 1; Packet - 1	Digitized
Carpological - 1; Photograph - 1	Digitized
Carpological - 1; Photograph - 1; Ref sheet - 1; Ref sheet - 1; Sheet - 1	Digitized
Carpological - 1; Photograph - 1; Ref sheet - 1; Ref sheet - 1; Sheet - 1; Spirit - 1	Digitized
Carpological - 1; Photograph - 1; Ref sheet - 1; Sheet - 1	Digitized
Carpological - 1; Photograph - 1; Sheet - 1	Digitized
Carpological - 1; Photograph - 1; Sheet - 1; Spirit - 1	Digitized
Carpological - 1; Photograph - 1; Sheet - 1; Wood - 1	Digitized
Carpological - 1; Photograph - 1; Sheet - 2	Digitized
Carpological - 1; Photograph - 4	Digitized
Carpological - 1; Ref sheet - 1	Sheet
Carpological - 1; Ref sheet - 1; Ref sheet - 1; Sheet - 1	Sheet
Carpological - 1; Ref sheet - 1; Ref sheet - 1; Sheet - 1; Spirit - 1	Sheet
Carpological - 1; Ref sheet - 1; Ref sheet - 1; Sheet - 1; Spirit - 1; Wood - 1	Sheet
Carpological - 1; Ref sheet - 1; Ref sheet - 1; Sheet - 1; Wood - 1	Sheet
Carpological - 1; Ref sheet - 1; Sheet - 1	Sheet
Carpological - 1; Ref sheet - 1; Sheet - 1; Silica gel sample - 1	Sheet
Carpological - 1; Ref sheet - 1; Sheet - 1; Spirit - 1	Sheet
Carpological - 1; Ref sheet - 1; Sheet - 1; Spirit - 1; Wood - 1	Sheet
Carpological - 1; Ref sheet - 1; Sheet - 1; Wood - 1	Sheet
Carpological - 1; Ref sheet - 1; Sheet - 2	Sheet
Carpological - 1; Sheet - 1	Sheet
Carpological - 1; Sheet - 1; Digital image (high resolution) - 1	Digitized
Carpological - 1; Sheet - 1; Silica gel sample - 1	Sheet
Carpological - 1; Sheet - 1; Spirit - 1	Sheet
Carpological - 1; Sheet - 1; Spirit - 1; Wood - 1	Sheet
Carpological - 1; Sheet - 1; Wood - 1	Sheet
Carpological - 1; Sheet - 2	Sheet
Carpological - 1; Sheet - 2; Spirit - 1	Sheet
Carpological - 1; Sheet - 3	Sheet
Carpological - 1; Sheet - 3; Spirit - 1	Sheet
Carpological - 1; Sheet - 5; Ref sheet - 1; Ref sheet - 1	Sheet
Carpological - 1; Silica gel sample - 1; Sheet - 1	Sheet
Carpological - 1; Spirit - 1	Sheet
Carpological - 1; Spirit - 1; Digital image (high resolution) - 1	Digitized
Carpological - 1; Spirit - 1; Digital image (high resolution) - 2	Digitized
Carpological - 3; Sheet - 1	Sheet
Cartilage	Unknown
Cast	Cast
Cast	Cast
Cast (+ wet specimen?)	Cast
Cast / destroyed	Cast
Chloretone/Tylers	Unknown
Chytrid Swab	Unknown
Cleared & Stained	Cleared and stained
Cleared & Stained	Cleared and stained
Cleared & stained	Cleared and stained
Cleared and stained	Cleared and stained
Cleared, alizarin stained	Cleared and stained
Cleared, alizarin stained (pectoral girdle)	Cleared and stained
Cranial	Unknown
Cranial bone, hyperossified	Unknown
Cranium	Head
Crop	Unknown
D	Unknown
D/102	Unknown
DEFORMED EMBRYO	Embryo
DESTROYED	Unknown
DISARTIC SKELETON	Skeleton
DISARTIC SKULL	Skull
DMSO	Unknown
DNA	DNA
DNA dilution	DNA
DNA extract	DNA
DNA extraction	DNA
DNA tissue	DNA
DNA tissue	DNA
DNA/tissue vouchered only	DNA
DRIED SKELETON	Dry
DRIED SPECIMEN	Dry
DRUM 34	Unknown
DRY	Dry
DRY SKELETON	Dry
DRY&STNED SKELETON	Dry
D[D]	Unknown
Degraded by thawing out	Unknown
Dental	Teeth
Dentary	Teeth
Dentary; Formalin & Alcohol	Teeth
Dentary; Other Fixative	Teeth
Dermestid beetle colony	Unknown
Dermestids	Unknown
Digital image (high resolution) - 1	Digitized
Digital image (high resolution) - 1; Sheet - 1	Digitized
Digital image (high resolution) - 1; Sheet - 1; Accessory documentation - 1	Digitized
Digital image (high resolution) - 2; Sheet - 1	Digitized
Digital image (high resolution) - 2; Sheet - 2	Digitized
Digital image (low resolution) - 1; Sheet - 1	Digitized
Dry	Dry
Dry	Dry
Dry Specimen	Dry
Dry Specimens	Dry
Egg	Eggs
Egg Sac	Eggs
Egg Sac	Eggs
Egg capsule	Eggs
Egg case containing embryo	Eggs
Egg case containing embryo plus one loose embryo	Eggs
Egg clutch	Eggs
Egg fragments	Eggs
Egg mass	Eggs
Egg only	Eggs
Egg(s)	Eggs
Egg(s)	Eggs
Egg, nest	Eggs
Egg/s	Eggs
Eggs	Eggs
Eggs, Nest	Eggs
Embryo + 5 eggs	Eggs
Embryo/s	Embryo
Embryo/s, Muscle	Embryo
Endoparasite	Unknown
Epoxy Resin	Epoxy
Epoxy Resin - whole	Epoxy
Ethanol	Spirit
Ethanol - unknown %	Spirit
Ethanol 100%	Spirit
Ethanol 70%	Spirit
Ethanol 90%	Spirit
Ethanol 95%	Spirit
Ethanol 96%	Spirit
Ethanol specimen	Spirit
Ethanol, absolute	Spirit
Etoh preserved tissue	Spirit
Eye	Eye
Eye and Gill arch/es	Eye
Eyeball	Eye
F	Unknown
FORMALIN	Unknown
FROG	Unknown
FRONT HALF ONLY	Unknown
FULLTERM EMBRYO	Embryo
Feather	Feather
Feather, sheath/s	Feather
Feather, tail shafts	Feather
Feather/s	Feather
Feathers	Feather
Field Herbarium, Fowlers Gap - 1; Sheet - 1	Sheet
Field Herbarium, Smiths Lake - 1	Sheet
Fin clip	Fin
Fin clip, Muscle	Fin
Fin, pectoral	Fin
Flensing knives	Unknown
Flipper	Unknown
Food	Unknown
Foot	Unknown
Formalin	Spirit
Formalin	Spirit
Formalin & Alcohol	Spirit
Formalin 10%	Spirit
Formalin fixed	Spirit
Fossil	Fossil
Frags	Frozen
Freeze Dried	Frozen
Freeze dried	Frozen
Freezer	Frozen
Frozen	Frozen
Frozen Tissue	Frozen
Frozen tissue	Frozen
Fungal culture	Culture
Fur	Unknown
Fur/hair	Unknown
GI Tract	Unknown
GREEN FORM	Unknown
Gamma irradiated	Unknown
Gastropod shell	Unknown
Gelatin capsule	Gelatin
Gelatin capsule	Gelatin
Genitalia Slide	Slide
Genitalia Slide	Slide
Genitalia mount	Mount
Genitalia mount	Mount
Genitalia preparation	Unknown
Genitalia vial	Vial
Genitalia vial	Vial
Gill arch/es	Unknown
Gill arch/es, Muscle	Unknown
Gill rakers	Unknown
Gland/s, anal	Glands
Gland/s, mammary glands	Glands
Gland/s, preputial	Glands
Gland/s, scent	Glands
Gland/s, venom	Glands
Glycerol (65%)	Spirit
Glycol & Alcohol	Spirit
Gonad/s	Eggs
Gonads/eggs	Eggs
Gut	Gut
Gut, dust with borax	Gut
Gut, dust with borax, bad job, used super glue	Gut
Gut, dust with borax, bad job.	Gut
Gut, dust with borax. Tegmen glued back. Part of abdomen fell off.	Gut
Gut; Ethanol	Gut
Gutted by 2 slit method, borax. Gravid, lot of eggs.	Gut
Gutted, dust with borax.	Gut
H	Unknown
HATCHLING	Unknown
HEAD & NECK ONLY	Head
HEAD ONLY	Head
HEAD,NECK,TAIL	Head
HEAD/NECK ONLY	Head
HEAD/TAIL ONLY	Head
HEMIPENES	Unknown
HOLO,4PARA	Unknown
Hair	Hair
Hair ball	Hair
Hair, Skin	Hair
Hatchling	Unknown
Hatchling larvae	Unknown
Head	Head
Head & tail	Head
Head + Tail	Head
Head mount	Head
Head only	Head
Head; Formalin & Alcohol	Head
Heart	Heart
Heart, Kidney	Heart
Heart, Kidney, Liver	Heart
Heart, Kidney, Liver, Muscle	Heart
Heart, Liver	Heart
Heart, Liver, Lung	Heart
Heart, Liver, Muscle	Heart
Heart, Liver, Spleen, Testes	Heart
Heart, Lung/s	Heart
Heart, Muscle	Heart
Heart, Spleen	Heart
Hindlimb	Unknown
Histological slide	Unknown
Horns	Unknown
Howard Springs	Unknown
IC	Unknown
III.1, III.2	Unknown
IV.1, ungual	Unknown
Illustration - 1; Photograph - 12; Packet - 1	Unknown
Image	Digitized
In prep	Unknown
Internal organs	Unknown
Intestine	Gut
Intestine, Liver	Gut
Intestine, stomach	Gut
Isopropanol	Unknown
J.B.,1,,,,447-97,Trawl,0,,,Marine,,,,Australia,035/0717,,,,18°05`S,119°44`E,-18.0833,119.7333,Marsh	Unknown
Jaw, Tooth (teeth)	Jaw
Jaws, skull	Jaw
K	Unknown
Kidney	Tissue
Kidney, Liver	Tissue
Kidney, Liver, Spleen	Tissue
Kidney, Muscle	Tissue
Klotz Solution	Unknown
Koen fluid	Unknown
L Fem	Bone
L MII.1	Unknown
L Tib	Unknown
L Tmt	Unknown
L cmc	Unknown
L cmc incomplete	Unknown
L cmc p+d unconnected	Unknown
L cor	Unknown
L cor incomplete	Unknown
L cor omal	Unknown
L coracoid	Unknown
L coracoid incomplete	Unknown
L coracoid omal	Unknown
L cuniform	Unknown
L fem	Bone
L fem (-d)	Bone
L fem (-head)	Bone
L fem incomplete	Bone
L femur	Bone
L femur adult (-p, - distal condyles)	Unknown
L femur incomplete	Unknown
L hum	Unknown
L hum complete	Unknown
L hum fragment	Unknown
L hum incomplete	Unknown
L hum, 2 indet frags	Unknown
L mand	Unknown
L pes	Unknown
L pes, lacking IV.4	Unknown
L pterygoid	Unknown
L qoj	Unknown
L quad	Unknown
L quadrate	Unknown
L rad	Unknown
L rad (2 pts	Unknown
L radius	Unknown
L radius, ulna, cmc	Unknown
L ramus mand (-cotyla)	Unknown
L scap	Unknown
L scapulocoracoid	Unknown
L tbt incomplete	Unknown
L tib	Unknown
L tib -p	Unknown
L tib incomplete	Unknown
L tib incoplete	Unknown
L tibiotarsus (missing prox and distal	Unknown
L tmt	Unknown
L tmt (-p)	Unknown
L tmt complete	Unknown
L tmt incomplete	Unknown
L tt	Unknown
L tt (-d)	Unknown
L ulna	Unknown
L ulna complete	Unknown
L ulna incomplete	Unknown
L.M. et al.,1,,,,576-93,,1993,8,10,Marine,,Montebello Islands,Hermite Island,Australia,StnMB1,,,,20°27`S,115°29.3`E,-20.45,115.4883,Marsh	Unknown
L.M.,1,,,,156-87,,0,,,Marine,,Houtman Abrolhos	Unknown
LARVAE	Larvae
LIMBS IN ALIZARIN	Unknown
LMII.1	Unknown
LN2	Unknown
Large packet - 1	Packet
Large packet - 1; Microscope slide - 1	Packet
Large packet - 1; Photograph - 1	Packet
Large packet - 1; Photograph - 1; Spirit - 1	Packet
Large packet - 1; Spirit - 1	Packet
Large packet - 1; Spore print - 1	Packet
Larva	Larvae
Larvae	Larvae
Leg	Unknown
Leg; Formalin & Alcohol	Unknown
Lip	Unknown
Liquid nitrogen	Unknown
Liver	Tissue
Liver, Muscle	Tissue
Liver, Muscle, Spleen, Testes	Tissue
Liver, Spleen	Tissue
Liver, Toe clip	Tissue
Liver, skin	Tissue
Ltt (-d)	Unknown
Lugol iodine	Unknown
Lung	Unknown
Lysis Buffer	Unknown
Lysis buffer	Unknown
M.	Unknown
MANDIBLE	Unknown
MANDIBLE & SPIRIT	Unknown
METAMORPH	Unknown
METAMORPH X2, FROG	Unknown
MII.1	Unknown
MOUNTED	Mount
MOUNTED SKELETON	Mount
MOUNTED SKIN	Mount
MUMMIFIED	Mummified
MUMMIFIED SPEC	Mummified
Mandible	Unknown
Mantle	Unknown
Melon	Unknown
Melon blubber	Unknown
Metamorphling	Unknown
Methyl Benz/Sal	Unknown
Methylated spirits	Spirit
Micro slide	Microslide
Micrograph - 1; Sheet - 1; Digital image (high resolution) - 1	Digitized
Micrograph - 1; Sheet - 2; Digital image (high resolution) - 2	Digitized
Microscope slide	Microslide
Microscope slide - 1	Microslide
Microscope slide - 10; SEM photo - 1; Packet - 1	Microslide
Microscope slide - 11; SEM photo - 1; Packet - 1	Microslide
Microscope slide - 12; SEM photo - 3; Packet - 1	Microslide
Microscope slide - 19; SEM photo - 1; Packet - 1	Microslide
Microscope slide - 1; Packet - 1	Microslide
Microscope slide - 1; Packet - 1; Photograph - 2	Microslide
Microscope slide - 1; Packet - 1; Photograph - 4	Microslide
Microscope slide - 1; Photograph - 1; Packet - 1	Microslide
Microscope slide - 1; Photograph - 2; Packet - 1	Microslide
Microscope slide - 1; Photograph - 3; Packet - 1	Microslide
Microscope slide - 1; SEM photo - 1	Microslide
Microscope slide - 1; SEM photo - 1; Packet - 1	Microslide
Microscope slide - 1; SEM photo - 2; Packet - 1	Microslide
Microscope slide - 1; SEM photo - 3; Packet - 1	Microslide
Microscope slide - 1; SEM photo - 4; Packet - 1	Microslide
Microscope slide - 1; Sheet - 1	Microslide
Microscope slide - 1; Sheet - 2	Microslide
Microscope slide - 1; Sheet - 3	Microslide
Microscope slide - 2; Packet - 1	Microslide
Microscope slide - 2; Photograph - 1; Packet - 1	Microslide
Microscope slide - 2; Photograph - 2; Packet - 1	Microslide
Microscope slide - 2; Photograph - 4; Packet - 1	Microslide
Microscope slide - 2; SEM photo - 1; Packet - 1	Microslide
Microscope slide - 2; SEM photo - 2; Packet - 1	Microslide
Microscope slide - 2; SEM photo - 3; Packet - 1	Microslide
Microscope slide - 2; Sheet - 1	Microslide
Microscope slide - 3; Packet - 1	Microslide
Microscope slide - 3; SEM photo - 1; Packet - 1	Microslide
Microscope slide - 3; SEM photo - 2; Packet - 1	Microslide
Microscope slide - 3; SEM photo - 3; Packet - 1	Microslide
Microscope slide - 4; Packet - 1	Microslide
Microscope slide - 4; SEM photo - 1; Packet - 1	Microslide
Microscope slide - 4; SEM photo - 2; Packet - 1	Microslide
Microscope slide - 4; SEM photo - 4; Packet - 1	Microslide
Microscope slide - 5; Packet - 1	Microslide
Microscope slide - 5; SEM photo - 1; Packet - 1	Microslide
Microscope slide - 6; Packet - 1	Microslide
Microscope slide - 6; SEM photo - 2; Packet - 1	Microslide
Microscope slide - 7; Packet - 1	Microslide
Microscope slide - 7; SEM photo - 3; Packet - 1	Microslide
Microscope slide - 7; SEM photo - 4; Packet - 1	Microslide
Microscope slide - 9; Packet - 1	Microslide
Microscope slide - 9; SEM photo - 1; Packet - 1	Microslide
Microscope slide - 9; SEM photo - 2; Packet - 1	Microslide
Microscope slide - 9; SEM photo - 3; Packet - 1	Microslide
Microslide	Microslide
Microvial	Unknown
Model	Unknown
Mount	Mount
Mount; Arsenic in legs	Mount
Mounted	Mount
Mounted Skeleton	Mount
Mounted Skin	Mount
Mounted skeleton	Mount
Mounted skin	Mount
Mounted skin?	Mount
Mounted; Skeleton	Mount
Mounted; Skull	Mount
Mounted; Skull; Formalin & Alcohol	Mount
Mummified	Mummified
Mummified	Mummified
Mummified; Formalin & Alcohol	Mummified
Muscle	Muscle
Muscle, Heart, Kidney, Liver	Muscle
Muscle, Pectoral Fin	Muscle
Muscle, Skin	Muscle
Muscle, leg	Muscle
Muscle, scale clip	Muscle
Museum Preserving Fluid	Spirit
Museum Vouchered (type)	Unknown
Museum voucher,	Unknown
NEONATE	Unknown
NEST/PHOTO	Nest
NEST/YOUNG	Nest
NET	Unknown
Nest	Nest
Nest	Nest
Nest and eggs	Nest
Nest/young	Nest
None	Unknown
Not Fixed	Unknown
Not Preserved	Unknown
O	Unknown
O(IC(IP)(WO)	Unknown
O(IP)	Unknown
O(IP)(IC)	Unknown
O(MSC)	Unknown
O(WO)	Unknown
ORGANS IN SPIRIT	Spirit
Only if not pinned specimens	Pinned
Originally in 100% ethanol	Spirit
Other	Unknown
Other	Unknown
Other Fixative	Unknown
Other; Alcohol	Spirit
Other; Formalin & Alcohol	Spirit
Other; Photo; Formalin & Alcohol	Spirit
Otolith	Otolith
Otoliths	Otolith
Otoliths	Otolith
Ovaries	Ovaries
Ovary/Ovaries	Ovaries
Oversized sheet	Sheet
P	Unknown
P(IC)	Unknown
P(IC)(IW)	Unknown
P(IC)(WO)	Unknown
P(IW)(WO)	Unknown
P(WO)	Unknown
P+sR femur	Unknown
P.F. & Sinclair	Unknown
PART MAND & SPIRIT	Spirit
PART SKELETON	Skeleton
PARTIAL SKELETON	Skeleton
PC	Unknown
PC(FS)	Unknown
PC(FS)(WO)	Unknown
PC(IW)	Unknown
PC(WO)	Unknown
PC(WO)O	Unknown
PCO	Unknown
PCO(WO)	Unknown
PCW	Unknown
PCWO	Unknown
PC[IW]	Unknown
PC[W]	Unknown
PHOTO	Digitized
PLASTRON	Unknown
PLATE 1	Plate
PLATE 10	Plate
PLATE 11	Plate
PLATE 12	Plate
PLATE 13	Plate
PLATE 14	Plate
PLATE 15	Plate
PLATE 16	Plate
PLATE 17	Plate
PLATE 18	Plate
PLATE 19	Plate
PLATE 2	Plate
PLATE 20	Plate
PLATE 21	Plate
PLATE 22	Plate
PLATE 24	Plate
PLATE 25	Plate
PLATE 27	Plate
PLATE 28	Plate
PLATE 29	Plate
PLATE 3	Plate
PLATE 30	Plate
PLATE 32	Plate
PLATE 33	Plate
PLATE 34	Plate
PLATE 35	Plate
PLATE 36	Plate
PLATE 37	Plate
PLATE 38	Plate
PLATE 39	Plate
PLATE 4	Plate
PLATE 40	Plate
PLATE 5	Plate
PLATE 6	Plate
PLATE 7	Plate
PLATE 8	Plate
PLATE 9	Plate
PO(IC)(WO)	Unknown
POSSIBLE LIVER PARASITE	Unknown
Packet	Packet
Packet - 1	Packet
Packet - 1; Digital image (high resolution) - 1	Digitized
Packet - 1; Digital image (high resolution) - 2	Digitized
Packet - 1; Digital image (high resolution) - 3	Digitized
Packet - 1; Microscope slide - 1	Microslide
Packet - 1; Microscope slide - 1; Photograph - 1	Microslide
Packet - 1; Microscope slide - 1; SEM photo - 1	Microslide
Packet - 1; Microscope slide - 1; SEM photo - 2	Microslide
Packet - 1; Microscope slide - 2	Microslide
Packet - 1; Microscope slide - 2; SEM photo - 1	Microslide
Packet - 1; Microscope slide - 3	Microslide
Packet - 1; Microscope slide - 3; SEM photo - 2	Microslide
Packet - 1; Microscope slide - 3; SEM photo - 3	Microslide
Packet - 1; Microscope slide - 4; SEM photo - 1	Microslide
Packet - 1; Microscope slide - 4; SEM photo - 2	Microslide
Packet - 1; Microscope slide - 5	Microslide
Packet - 1; Microscope slide - 5; SEM photo - 1	Microslide
Packet - 1; Microscope slide - 5; SEM photo - 2	Microslide
Packet - 1; Microscope slide - 6; SEM photo - 3	Microslide
Packet - 1; Microscope slide - 7	Microslide
Packet - 1; Microscope slide - 8	Microslide
Packet - 1; Microscope slide - 9	Microslide
Packet - 1; Packet - 1	Packet
Packet - 1; Photograph - 1	Digitized
Packet - 1; Photograph - 15	Digitized
Packet - 1; Photograph - 1; Microscope slide - 1	Microslide
Packet - 1; Photograph - 1; Silica gel sample - 1; Microscope slide - 1; Illustration - 1	Microslide
Packet - 1; Photograph - 1; Spirit - 1	Digitized
Packet - 1; Photograph - 1; Spore print - 1	Digitized
Packet - 1; Photograph - 2	Digitized
Packet - 1; Photograph - 2; Spore print - 1	Digitized
Packet - 1; Photograph - 3	Digitized
Packet - 1; Photograph - 4	Digitized
Packet - 1; Photograph - 4; Microscope slide - 2	Microslide
Packet - 1; Photograph - 5; Spore print - 1	Digitized
Packet - 1; Photograph - 6; Spore print - 1	Digitized
Packet - 1; SEM photo - 1	Digitized
Packet - 1; SEM photo - 2	Digitized
Packet - 1; SEM photo - 3	Digitized
Packet - 1; SEM photo - 4	Digitized
Packet - 1; Sheet - 1	Sheet
Packet - 1; Silica gel sample - 1	Packet
Packet - 1; Spirit - 1	Packet
Packet - 1; Spore print - 1	Packet
Packet - 1; Spore print - 1; Microscope slide - 2	Microslide
Packet - 1; Spore print - 1; Photograph - 1	Digitized
Packet - 1; Spore print - 1; Photograph - 2	Digitized
Packet - 1; Spore print - 2; Photograph - 1	Digitized
Packet - 2	Packet
Packet - 3	Packet
Packet - 4	Packet
Papered	Papered
Paraloid	Digitized
Parasite	Parasite
Parasite (internal)	Parasite
Part skeleton	Skeleton
Partial Skeleton	Skeleton
Pectoral Fin, RHS	Unknown
Pellet	Unknown
Penis	Unknown
Phalanx	Unknown
Phalanx III.1	Unknown
Phalanx III.2	Unknown
Phalanx, Prox humerus + frags	Unknown
Phallus	Unknown
Photo	Digitized
Photo; Formalin & Alcohol	Spirit
Photograph	Digitized
Photograph - 0; Sheet - 1	Digitized
Photograph - 1	Digitized
Photograph - 1; Large packet - 1	Digitized
Photograph - 1; Microscope slide - 1; Packet - 1	Microslide
Photograph - 1; Microscope slide - 1; Silica gel sample - 1; Packet - 1	Microslide
Photograph - 1; Packet - 1	Digitized
Photograph - 1; Packet - 1; Spore print - 1	Digitized
Photograph - 1; Ref sheet - 1; Ref sheet - 1; Ref sheet - 1; Sheet - 1	Digitized
Photograph - 1; Ref sheet - 1; Ref sheet - 1; Sheet - 1	Digitized
Photograph - 1; Ref sheet - 1; Ref sheet - 1; Sheet - 1; Spirit - 1	Digitized
Photograph - 1; Ref sheet - 1; Ref sheet - 1; Sheet - 2	Digitized
Photograph - 1; Ref sheet - 1; Sheet - 1	Digitized
Photograph - 1; Ref sheet - 1; Sheet - 1; Ref sheet - 1	Digitized
Photograph - 1; Ref sheet - 1; Sheet - 1; Spirit - 1	Digitized
Photograph - 1; Ref sheet - 1; Sheet - 2	Digitized
Photograph - 1; Ref sheet - 1; Sheet - 2; Silica gel sample - 1; Ref sheet - 1	Digitized
Photograph - 1; Ref sheet - 1; Sheet - 2; Spirit - 1	Digitized
Photograph - 1; Ref sheet - 1; Sheet - 3; Spirit - 1	Digitized
Photograph - 1; Sheet - 1	Digitized
Photograph - 1; Sheet - 1; Ref sheet - 1	Digitized
Photograph - 1; Sheet - 1; Sheet - 1	Digitized
Photograph - 1; Sheet - 1; Sheet - 1; Ref sheet - 1	Digitized
Photograph - 1; Sheet - 1; Silica gel sample - 1	Digitized
Photograph - 1; Sheet - 1; Silica gel sample - 1; Spirit - 1	Digitized
Photograph - 1; Sheet - 1; Spirit - 1	Digitized
Photograph - 1; Sheet - 1; Spirit - 1; Sheet - 1	Digitized
Photograph - 1; Sheet - 1; Spirit - 1; Silica gel sample - 1	Digitized
Photograph - 1; Sheet - 1; Spirit - 1; Spirit - 1	Digitized
Photograph - 1; Sheet - 1; Spirit - 1; Wood - 1	Digitized
Photograph - 1; Sheet - 1; Wood - 1	Digitized
Photograph - 1; Sheet - 2	Digitized
Photograph - 1; Sheet - 2; Carpological - 1	Digitized
Photograph - 1; Sheet - 2; Spirit - 1	Digitized
Photograph - 1; Sheet - 3	Digitized
Photograph - 1; Sheet - 3; Sheet - 1	Digitized
Photograph - 1; Sheet - 3; Spirit - 1	Digitized
Photograph - 1; Sheet - 4	Digitized
Photograph - 1; Sheet - 6	Digitized
Photograph - 1; Silica gel sample - 1; Packet - 1; Illustration - 1	Digitized
Photograph - 1; Spirit - 1	Digitized
Photograph - 1; Spore print - 1; Packet - 1	Digitized
Photograph - 2; Microscope slide - 1; Packet - 1	Digitized
Photograph - 2; Microscope slide - 1; Packet - 1; Spore print - 1	Digitized
Photograph - 2; Packet - 1	Digitized
Photograph - 2; Packet - 1; Microscope slide - 1	Digitized
Photograph - 2; Packet - 1; Spore print - 1	Digitized
Photograph - 2; Ref sheet - 1; Sheet - 1	Digitized
Photograph - 2; Sheet - 1	Digitized
Photograph - 2; Sheet - 1; Sheet - 1	Digitized
Photograph - 2; Sheet - 2	Digitized
Photograph - 2; Spore print - 2; Packet - 1	Digitized
Photograph - 3; Microscope slide - 2; Packet - 1	Digitized
Photograph - 3; Packet - 1; Microscope slide - 1	Digitized
Photograph - 3; Packet - 1; Spore print - 1	Digitized
Photograph - 3; Sheet - 1	Digitized
Photograph - 3; Sheet - 1; Silica gel sample - 1	Digitized
Photograph - 3; Silica gel sample - 1; Sheet - 1	Digitized
Photograph - 3; Silica gel sample - 1; Spirit - 1; Carpological - 1; Sheet - 2	Digitized
Photograph - 3; Spore print - 1; Packet - 1	Digitized
Photograph - 4; Packet - 1	Digitized
Photograph - 4; Sheet - 2; Spirit - 1	Digitized
Photograph - 4; Sheet - 3	Digitized
Photograph - 4; Spore print - 1; Packet - 1	Digitized
Photograph - 5; Packet - 1	Digitized
Photograph - 5; Sheet - 1	Digitized
Photograph - 5; Sheet - 1; Spirit - 1; Silica gel sample - 1	Digitized
Photograph - 5; Silica gel sample - 1; Sheet - 1	Digitized
Photograph - 5; Silica gel sample - 1; Sheet - 2	Digitized
Photograph - 9; Sheet - 2; Ref sheet - 1; Photograph - 3; Silica gel sample - 1	Digitized
Photograph - 9; Sheet - 3	Digitized
Photographic slide	Digitized
Photographic slide - 1; Duplicate - 2; Sheet - 1	Digitized
Photographic slide - 3; Sheet - 3; Digital image (high resolution) - 2	Digitized
Pieces of sloughed skin	Skin
Pin	Pinned
Pin	Pinned
Pinned	Pinned
Pinned specimen	Pinned
Plasma	Unknown
Plastinated	Unknown
Plate	Plate
Point	Unknown
Point	Unknown
Poor specimen, both legDiscardedmissing	Unknown
Postcranial	Unknown
Postcranial; Formalin & Alcohol	Spirit
Postlarvae	Larvae
Pouch folds	Unknown
Premaxilla	Unknown
Prepared dry specimen	Dry
Preservative not recorded	Unknown
Preserved tissue	Tissue
R	Unknown
R Fem	Unknown
R M2.1	Unknown
R MAND & SPIRIT	Unknown
R MII.1	Unknown
R Tib	Unknown
R Tmt	Unknown
R cmc	Unknown
R cmc complete	Unknown
R cmc incomplete	Unknown
R complete pes	Unknown
R complete pes & d tmt	Unknown
R cor	Unknown
R cor (-stern end)	Unknown
R cor (2 pts)	Unknown
R cor omal	Unknown
R coracoid	Unknown
R coracoid (juv.)	Unknown
R coracoid incomplete	Unknown
R coracoid omal	Unknown
R coracoid sternal	Unknown
R cuniform	Unknown
R digit II (3 phal)	Unknown
R digit III (4 phals)	Unknown
R digit IV (3 phal)	Unknown
R fem	Unknown
R fem incomplete	Unknown
R femur	Unknown
R femur incomplete	Unknown
R fibula	Unknown
R hum	Unknown
R hum complete	Unknown
R hum fragment	Unknown
R hum incomplete	Unknown
R hum juv	Unknown
R mand	Unknown
R manus phal II.1	Unknown
R pes	Unknown
R pterygoid	Unknown
R quad	Unknown
R quad worn	Unknown
R quadrate	Unknown
R rad (missing prox and dist ends)	Unknown
R radius	Unknown
R radius incomplete	Unknown
R ramus mand	Unknown
R scap	Unknown
R scapulocoracoid	Unknown
R side cranium	Unknown
R side mand	Unknown
R tib	Unknown
R tib (-d)	Unknown
R tib incomplete	Unknown
R tmt	Unknown
R tmt (-p)	Unknown
R tmt (-trochlea and cotyla)	Unknown
R tmt complete	Unknown
R tmt incomplete	Unknown
R tmt, dl tt, dR hum, pL ulna, pR hum, dR tt, pelvis, pR cmc	Unknown
R ulna	Unknown
R ulna incomplete	Unknown
R ulnare	Unknown
R(-prox) hum	Unknown
RIV.1	Unknown
RMII.1	Unknown
RNALater	RNA
RNAlater	RNA
Record Only	Unknown
Ref sheet - 0; Ref sheet - 0; Sheet - 1	Sheet
Ref sheet - 0; Sheet - 1	Sheet
Ref sheet - 1	Sheet
Ref sheet - 1; Carpological - 1; Sheet - 1	Sheet
Ref sheet - 1; Photograph - 1; Sheet - 1	Digitized
Ref sheet - 1; Photograph - 2; Sheet - 1	Digitized
Ref sheet - 1; Photograph - 3; Sheet - 1	Digitized
Ref sheet - 1; Ref sheet - 1	Sheet
Ref sheet - 1; Ref sheet - 1; Ref sheet - 1; Sheet - 1	Sheet
Ref sheet - 1; Ref sheet - 1; Ref sheet - 1; Sheet - 1; Spirit - 1	Sheet
Ref sheet - 1; Ref sheet - 1; Ref sheet - 1; Sheet - 2	Sheet
Ref sheet - 1; Ref sheet - 1; Ref sheet - 1; Sheet - 3	Sheet
Ref sheet - 1; Ref sheet - 1; Sheet - 1	Sheet
Ref sheet - 1; Ref sheet - 1; Sheet - 1; Silica gel sample - 1	Sheet
Ref sheet - 1; Ref sheet - 1; Sheet - 1; Silica gel sample - 1; Spirit - 1; Spirit - 1	Sheet
Ref sheet - 1; Ref sheet - 1; Sheet - 1; Spirit - 1	Sheet
Ref sheet - 1; Ref sheet - 1; Sheet - 1; Spirit - 1; Wood - 1	Sheet
Ref sheet - 1; Ref sheet - 1; Sheet - 1; Spirit - 1; Wood - 1; Spirit - 1	Sheet
Ref sheet - 1; Ref sheet - 1; Sheet - 1; Wood - 1	Sheet
Ref sheet - 1; Ref sheet - 1; Sheet - 1; Wood - 1; Silica gel sample - 1	Sheet
Ref sheet - 1; Ref sheet - 1; Sheet - 2	Sheet
Ref sheet - 1; Ref sheet - 1; Sheet - 2; Ref sheet - 2	Sheet
Ref sheet - 1; Ref sheet - 1; Sheet - 2; Spirit - 1	Sheet
Ref sheet - 1; Ref sheet - 1; Sheet - 2; Spirit - 1; Silica gel sample - 1	Sheet
Ref sheet - 1; Ref sheet - 1; Sheet - 2; Spirit - 1; Wood - 1	Sheet
Ref sheet - 1; Ref sheet - 1; Sheet - 2; Wood - 1	Sheet
Ref sheet - 1; Ref sheet - 1; Sheet - 3	Sheet
Ref sheet - 1; Ref sheet - 1; Sheet - 4	Sheet
Ref sheet - 1; Ref sheet - 1; Sheet - 4; Spirit - 1	Sheet
Ref sheet - 1; Ref sheet - 1; Sheet - 4; Spirit - 1; Wood - 1	Sheet
Ref sheet - 1; Ref sheet - 1; Silica gel sample - 1; Sheet - 1	Sheet
Ref sheet - 1; Ref sheet - 2; Sheet - 1	Sheet
Ref sheet - 1; Ref sheet - 2; Sheet - 1; Spirit - 1; Silica gel sample - 1	Sheet
Ref sheet - 1; Ref sheet - 2; Sheet - 2	Sheet
Ref sheet - 1; Sheet - 1	Sheet
Ref sheet - 1; Sheet - 1; Carpological - 1	Sheet
Ref sheet - 1; Sheet - 1; Photograph - 1	Sheet
Ref sheet - 1; Sheet - 1; Ref sheet - 1	Sheet
Ref sheet - 1; Sheet - 1; Silica gel sample - 1	Sheet
Ref sheet - 1; Sheet - 1; Silica gel sample - 2	Sheet
Ref sheet - 1; Sheet - 1; Spirit - 1	Sheet
Ref sheet - 1; Sheet - 1; Spirit - 1; Silica gel sample - 1	Sheet
Ref sheet - 1; Sheet - 1; Spirit - 1; Spirit - 1	Sheet
Ref sheet - 1; Sheet - 1; Spirit - 1; Wood - 1	Sheet
Ref sheet - 1; Sheet - 1; Wood - 1	Sheet
Ref sheet - 1; Sheet - 2	Sheet
Ref sheet - 1; Sheet - 2; Ref sheet - 1	Sheet
Ref sheet - 1; Sheet - 2; Silica gel sample - 1	Sheet
Ref sheet - 1; Sheet - 2; Spirit - 1	Sheet
Ref sheet - 1; Sheet - 2; Spirit - 1; Silica gel sample - 1	Sheet
Ref sheet - 1; Sheet - 2; Wood - 1	Sheet
Ref sheet - 1; Sheet - 3	Sheet
Ref sheet - 1; Sheet - 3; Ref sheet - 1	Sheet
Ref sheet - 1; Sheet - 3; Ref sheet - 3	Sheet
Ref sheet - 1; Sheet - 3; Spirit - 1	Sheet
Ref sheet - 1; Sheet - 4	Sheet
Ref sheet - 1; Sheet - 7	Sheet
Ref sheet - 1; Silica gel sample - 1; Sheet - 1	Sheet
Ref sheet - 1; Silica gel sample - 1; Sheet - 1; Spirit - 1	Sheet
Ref sheet - 1; Silica gel sample - 1; Spirit - 1; Sheet - 1	Sheet
Ref sheet - 1; Spirit - 1	Sheet
Ref sheet - 1; Spirit - 1; Sheet - 1	Sheet
Ref sheet - 1; Spirit - 1; Sheet - 2	Sheet
Ref sheet - 1; Spirit - 1; Silica gel sample - 1; Sheet - 1	Sheet
Ref sheet - 2; Ref sheet - 1; Sheet - 1	Sheet
Ref sheet - 2; Ref sheet - 1; Sheet - 2	Sheet
Ref sheet - 2; Sheet - 1	Sheet
Ref sheet - 2; Sheet - 1; Spirit - 1	Sheet
Ref sheet - 2; Sheet - 2	Sheet
Ref sheet - 2; Sheet - 3	Sheet
Ref sheet - 3; Ref sheet - 2; Sheet - 5; Spirit - 1; Silica gel sample - 1	Sheet
Ref sheet - 3; Sheet - 1	Sheet
Ref sheet - 3; Sheet - 2	Sheet
Ref sheet - 3; Sheet - 3	Sheet
Reproductive Organs	Unknown
Resin mounted block	Unknown
Rib?	Unknown
Rtmt shaft	Unknown
S	Unknown
S&C	Unknown
S(IC)	Unknown
S(IC)(IW)	Unknown
S(IP)	Unknown
S(IP)(IC)	Unknown
S(IP)C	Unknown
S(IP)C(WO)	Unknown
S(IW)	Unknown
SAMA,MaterialSample,PhysicalObject,AustralianBiologicalTissueCollection,Sminthopsis dolichura Kitchener	Unknown
SC	Unknown
SC (WO)	Unknown
SC(IP)	Unknown
SC(IW)	Unknown
SC(WO)	Unknown
SC(WO)(IP)	Unknown
SCW	Unknown
SC[IW]	Unknown
SC[W]	Unknown
SEM mount	Mount
SEM mount	Mount
SEM photo - 1; Packet - 1	Digitized
SEM photo - 2; Packet - 1	Digitized
SEM photo - 3; Packet - 1	Digitized
SEM photo - 4; Packet - 1	Digitized
SEM photo - 5; Packet - 1	Digitized
SEM photo - 6; Packet - 1	Digitized
SEM prep - Skin, tooth	Skin
SEM stub	Unknown
SEM stubs	Unknown
SEX?	Unknown
SHED SKIN	Skin
SHELL	Shell
SHELL ONLY	Shell
SK,MAND,AXIS/ATLAS	Unknown
SKELETON	Skeleton
SKELETON & SPIRIT	Skeleton
SKELETON & skin	Skeleton
SKELETON & skull	Skeleton
SKELETON - PART	Skeleton
SKELETON-STAINED	Skeleton
SKIN	Skin
SKIN & SKULL	Skin
SKIN IN SPIRIT	Skin
SKIN MOUNT&PT SKEL	Skin
SKIN ONLY	Skin
SKIN/SKULL	Skin
SKULL	Skull
SKULL & CARAPACE	Skull
SKULL & CAST	Skull
SKULL & DEHYD.BODY	Skull
SKULL & MANDIBLE	Skull
SKULL & MANDIBLE & SPIRIT	Skull
SKULL & SKIN	Skull
SKULL & SPIRIT	Skull
SKULL & VERT.	Skull
SKULL ONLY	Skull
SKULL,CARA & PLAST	Skull
SKULL,DAMAGED	Skull
SKULL,MAND,ATLAS	Skull
SKULL,MAND,AX/AT	Skull
SKULL,MAND,AX/ATL	Skull
SKULL,MAND,VERT	Skull
SKULL,SKELETON	Skull
SKULL-ALIZARIN	Skull
SKULL-HEAD/NECK	Skull
SKULL-SPIRIT	Skull
SKULL/SKELETON	Skull
SLOUGH	Unknown
SLOUGH ONLY	Unknown
SO	Unknown
SP	Unknown
SP(IC)	Unknown
SPC	Unknown
SPC(WO)	Unknown
SPC[W]	Unknown
SPECIAL	Unknown
SPIRIT & RT MAND	Spirit
SPIRIT & SKULL	Spirit
SPIRIT & SKULL fragments	Spirit
SPIRIT,SKULL,MAND	Spirit
STAINED SKELETON	Skeleton
SUBADULT	Unknown
Saline ethanol	Spirit
Scale/s	Unknown
Scales, tail tip	Unknown
Scat	Unknown
Scat, Owl Pellet, Ambergris	Unknown
Seed collection	Unknown
Seminal vesicles	Unknown
Seutin Solution	Unknown
Sheet	Sheet
Sheet - 1	Sheet
Sheet - 10	Sheet
Sheet - 11	Sheet
Sheet - 13	Sheet
Sheet - 14; Duplicate - 1	Sheet
Sheet - 1; Accessory documentation - 1	Sheet
Sheet - 1; Boxed algae - 1	Sheet
Sheet - 1; Carpological - 0	Sheet
Sheet - 1; Carpological - 1	Sheet
Sheet - 1; Carpological - 1; Digital image (high resolution) - 1	Sheet
Sheet - 1; Carpological - 1; Digital image (high resolution) - 2	Sheet
Sheet - 1; Carpological - 1; Spirit - 1; Digital image (high resolution) - 1	Sheet
Sheet - 1; Carpological - 1; Spirit - 1; Digital image (high resolution) - 2	Sheet
Sheet - 1; Carpological - 2	Sheet
Sheet - 1; Digital image (high resolution) - 1	Sheet
Sheet - 1; Digital image (high resolution) - 2	Sheet
Sheet - 1; Digital image (high resolution) - 3	Sheet
Sheet - 1; Digital image (high resolution) - 4	Sheet
Sheet - 1; Duplicate - 1	Sheet
Sheet - 1; Duplicate - 10	Sheet
Sheet - 1; Duplicate - 1; Duplicate - 1	Sheet
Sheet - 1; Duplicate - 1; Field Herbarium, Smiths Lake - 1	Sheet
Sheet - 1; Duplicate - 2	Sheet
Sheet - 1; Duplicate - 2; Photographic slide - 1	Sheet
Sheet - 1; Duplicate - 3	Sheet
Sheet - 1; Duplicate - 4	Sheet
Sheet - 1; Duplicate - 5	Sheet
Sheet - 1; Duplicate - 6	Sheet
Sheet - 1; Duplicate - 7	Sheet
Sheet - 1; Duplicate - 8	Sheet
Sheet - 1; Duplicate - 9	Sheet
Sheet - 1; Field Herbarium, Fowlers Gap - 1	Sheet
Sheet - 1; Field Herbarium, Smiths Lake - 1	Sheet
Sheet - 1; Microscope slide - 1	Sheet
Sheet - 1; Microscope slide - 2	Sheet
Sheet - 1; Photograph - 1	Sheet
Sheet - 1; Photograph - 13	Sheet
Sheet - 1; Photograph - 1; Photograph - 1	Sheet
Sheet - 1; Photograph - 1; Ref sheet - 1	Sheet
Sheet - 1; Photograph - 2	Sheet
Sheet - 1; Photograph - 3	Sheet
Sheet - 1; Photograph - 4	Sheet
Sheet - 1; Photograph - 5	Sheet
Sheet - 1; Photographic slide - 1	Sheet
Sheet - 1; Photographic slide - 1; Duplicate - 1	Sheet
Sheet - 1; Photographic slide - 1; Duplicate - 2	Sheet
Sheet - 1; Photographic slide - 2	Sheet
Sheet - 1; Photographic slide - 3	Sheet
Sheet - 1; Photographic slide - 3; Duplicate - 1	Sheet
Sheet - 1; Photographic slide - 3; Duplicate - 2	Sheet
Sheet - 1; Photographic slide - 3; Duplicate - 3	Sheet
Sheet - 1; Ref sheet - 1	Sheet
Sheet - 1; Ref sheet - 1; Photograph - 2	Sheet
Sheet - 1; Ref sheet - 1; Ref sheet - 1	Sheet
Sheet - 1; Ref sheet - 1; Ref sheet - 1; Ref sheet - 1	Sheet
Sheet - 1; Ref sheet - 1; Ref sheet - 1; Spirit - 1	Sheet
Sheet - 1; Ref sheet - 1; Silica gel sample - 1	Sheet
Sheet - 1; Ref sheet - 1; Spirit - 1	Sheet
Sheet - 1; Ref sheet - 2	Sheet
Sheet - 1; Ref sheet - 2; Silica gel sample - 1	Sheet
Sheet - 1; Sheet - 1	Sheet
Sheet - 1; Sheet - 1; Carpological - 1; Digital image (high resolution) - 2	Sheet
Sheet - 1; Sheet - 1; Digital image (high resolution) - 2	Sheet
Sheet - 1; Sheet - 1; Ref sheet - 1	Sheet
Sheet - 1; Sheet - 2	Sheet
Sheet - 1; Sheet - 2; Sheet - 2	Sheet
Sheet - 1; Sheet - 3	Sheet
Sheet - 1; Sheet - 4	Sheet
Sheet - 1; Silica gel sample - 1	Sheet
Sheet - 1; Silica gel sample - 1; Carpological - 1	Sheet
Sheet - 1; Silica gel sample - 1; Carpological - 1; Spirit - 1	Sheet
Sheet - 1; Silica gel sample - 1; Silica gel sample - 1	Sheet
Sheet - 1; Silica gel sample - 1; Silica gel sample - 1; Silica gel sample - 1	Sheet
Sheet - 1; Silica gel sample - 1; Spirit - 1	Sheet
Sheet - 1; Silica gel sample - 2	Sheet
Sheet - 1; Spirit - 1	Sheet
Sheet - 1; Spirit - 1; Digital image (high resolution) - 1	Sheet
Sheet - 1; Spirit - 1; Ref sheet - 1	Sheet
Sheet - 1; Spirit - 1; Ref sheet - 1; Ref sheet - 1	Sheet
Sheet - 1; Spirit - 1; Silica gel sample - 1	Sheet
Sheet - 1; Spirit - 1; Silica gel sample - 1; Silica gel sample - 1	Sheet
Sheet - 1; Spirit - 1; Silica gel sample - 2	Sheet
Sheet - 1; Spirit - 1; Spirit - 1	Sheet
Sheet - 1; Spirit - 1; Wood - 1	Sheet
Sheet - 1; Spirit - 1; Wood - 1; Ref sheet - 1	Sheet
Sheet - 1; Wood - 1	Sheet
Sheet - 2	Sheet
Sheet - 2; Boxed algae - 1	Sheet
Sheet - 2; Carpological - 1	Sheet
Sheet - 2; Carpological - 1; Digital image (high resolution) - 3	Sheet
Sheet - 2; Carpological - 1; Digital image (high resolution) - 5; Accessory documentation - 1	Sheet
Sheet - 2; Carpological - 1; Spirit - 1; Digital image (high resolution) - 3	Sheet
Sheet - 2; Digital image (high resolution) - 1	Sheet
Sheet - 2; Digital image (high resolution) - 2	Sheet
Sheet - 2; Digital image (high resolution) - 3	Sheet
Sheet - 2; Digital image (high resolution) - 3; Spirit - 1	Sheet
Sheet - 2; Digital image (high resolution) - 4	Sheet
Sheet - 2; Duplicate - 1	Sheet
Sheet - 2; Photograph - 1	Sheet
Sheet - 2; Photographic slide - 1	Sheet
Sheet - 2; Photographic slide - 1; Duplicate - 1	Sheet
Sheet - 2; Photographic slide - 2	Sheet
Sheet - 2; Photographic slide - 3	Sheet
Sheet - 2; Photographic slide - 3; Duplicate - 1	Sheet
Sheet - 2; Photographic slide - 4; Duplicate - 1	Sheet
Sheet - 2; Ref sheet - 1	Sheet
Sheet - 2; Ref sheet - 1; Ref sheet - 1	Sheet
Sheet - 2; Ref sheet - 2	Sheet
Sheet - 2; Ref sheet - 2; Ref sheet - 2; Spirit - 1	Sheet
Sheet - 2; Ref sheet - 3	Sheet
Sheet - 2; Sheet - 1	Sheet
Sheet - 2; Sheet - 2	Sheet
Sheet - 2; Silica gel sample - 1	Sheet
Sheet - 2; Silica gel sample - 1; Spirit - 1	Sheet
Sheet - 2; Spirit - 1	Sheet
Sheet - 2; Spirit - 1; Digital image (high resolution) - 2	Sheet
Sheet - 2; Spirit - 1; Silica gel sample - 1	Sheet
Sheet - 2; Spirit - 1; Wood - 1	Sheet
Sheet - 2; Wood - 1	Sheet
Sheet - 3	Sheet
Sheet - 3; Carpological - 1	Sheet
Sheet - 3; Carpological - 1; Digital image (high resolution) - 4	Sheet
Sheet - 3; Carpological - 1; Spirit - 1; Digital image (high resolution) - 4	Sheet
Sheet - 3; Digital image (high resolution) - 1	Sheet
Sheet - 3; Digital image (high resolution) - 2	Sheet
Sheet - 3; Digital image (high resolution) - 3	Sheet
Sheet - 3; Digital image (high resolution) - 4	Sheet
Sheet - 3; Duplicate - 2	Sheet
Sheet - 3; Duplicate - 3	Sheet
Sheet - 3; Photograph - 2	Sheet
Sheet - 3; Ref sheet - 1	Sheet
Sheet - 3; Ref sheet - 1; Ref sheet - 1	Sheet
Sheet - 3; Ref sheet - 1; Ref sheet - 2; Ref sheet - 2	Sheet
Sheet - 3; Ref sheet - 3	Sheet
Sheet - 3; Sheet - 1	Sheet
Sheet - 3; Silica gel sample - 1; Ref sheet - 1	Sheet
Sheet - 3; Spirit - 1	Sheet
Sheet - 3; Spirit - 1; Silica gel sample - 1	Sheet
Sheet - 3; Spirit - 1; Wood - 1	Sheet
Sheet - 3; Wood - 1	Sheet
Sheet - 4	Sheet
Sheet - 4; Digital image (high resolution) - 1	Sheet
Sheet - 4; Digital image (high resolution) - 2	Sheet
Sheet - 4; Digital image (high resolution) - 3	Sheet
Sheet - 4; Digital image (high resolution) - 4	Sheet
Sheet - 4; Microscope slide - 5	Sheet
Sheet - 4; Photograph - 1	Sheet
Sheet - 4; Silica gel sample - 1	Sheet
Sheet - 4; Spirit - 1	Sheet
Sheet - 4; Spirit - 1; Digital image (high resolution) - 4	Sheet
Sheet - 5	Sheet
Sheet - 5; Carpological - 1; Digital image (high resolution) - 6	Sheet
Sheet - 5; Digital image (high resolution) - 2	Sheet
Sheet - 5; Digital image (high resolution) - 3	Sheet
Sheet - 5; Digital image (high resolution) - 4	Sheet
Sheet - 5; Digital image (high resolution) - 5	Sheet
Sheet - 5; Spirit - 1	Sheet
Sheet - 5; Wood - 1	Sheet
Sheet - 6	Sheet
Sheet - 6; Spirit - 1	Sheet
Sheet - 7	Sheet
Sheet - 8	Sheet
Sheet - 9	Sheet
Sheet; Ref sheet	Sheet
Shell	Shell
Shell	Shell
Shell, skin	Shell
Shipping material - 1	Unknown
Silica gel sample	Sillica
Silica gel sample - 10; Spirit - 1; Silica gel sample - 1	Sillica
Silica gel sample - 1; Packet - 1	Sillica
Silica gel sample - 1; Ref sheet - 1	Sillica
Silica gel sample - 1; Ref sheet - 1; Ref sheet - 1; Sheet - 1	Sillica
Silica gel sample - 1; Ref sheet - 1; Sheet - 1	Sillica
Silica gel sample - 1; Ref sheet - 1; Sheet - 1; Silica gel sample - 1	Sillica
Silica gel sample - 1; Ref sheet - 1; Sheet - 2	Sillica
Silica gel sample - 1; Sheet - 1	Sillica
Silica gel sample - 1; Sheet - 1; Carpological - 1	Sillica
Silica gel sample - 1; Sheet - 1; Digital image (high resolution) - 1	Sillica
Silica gel sample - 1; Sheet - 1; Ref sheet - 1	Sillica
Silica gel sample - 1; Sheet - 1; Spirit - 1	Sillica
Silica gel sample - 1; Sheet - 1; Spirit - 1; Spirit - 1	Sillica
Silica gel sample - 1; Sheet - 2	Sillica
Silica gel sample - 1; Sheet - 2; Carpological - 1	Sillica
Silica gel sample - 1; Sheet - 3	Sillica
Silica gel sample - 1; Silica gel sample - 1	Sillica
Silica gel sample - 1; Spirit - 1; Sheet - 1	Sillica
Silica gel sample - 1; Spirit - 1; Sheet - 2	Sillica
Silica gel sample - 1; Spore print - 1; Packet - 1	Sillica
Skeletal	Skeleton
Skeletal parts	Skeleton
Skeletal parts	Skeleton
Skeleton	Skeleton
Skeleton	Skeleton
Skeleton (articulated)	Skeleton
Skeleton (disarticulated)	Skeleton
Skeleton (part)	Skeleton
Skeleton (postcranial)	Skeleton
Skeleton and dry skin	Skeleton
Skeleton and skin	Skeleton
Skeleton, skull	Skeleton
Skeleton- Cranium	Skeleton
Skeleton/Skull	Skeleton
Skeleton/Skull; Formalin & Alcohol	Skeleton
Skeleton/Wet	Skeleton
Skeleton; Formalin & Alcohol	Skeleton
Skeleton; Photo	Skeleton
Skin	Skin
Skin	Skin
Skin & Feathers	Skin
Skin & Feathers; Formalin & Alcohol	Skin
Skin & Partial Skeleton	Skin
Skin & Skeleton	Skin
Skin & Skull	Skin
Skin & Wing	Skin
Skin (pelt)	Skin
Skin + Eggs	Skin
Skin + Feather	Skin
Skin + Skeleton; Formalin & Alcohol	Skin
Skin + Skull	Skin
Skin + Wing	Skin
Skin + Wing + Feather	Skin
Skin + Wing; Formalin & Alcohol	Skin
Skin + wing	Skin
Skin and Skeleton; Formalin & Alcohol	Skin
Skin in spirit	Skin
Skin object	Skin
Skin swab	Skin
Skin, Blubber, Muscle	Skin
Skin, Wing(s)	Skin
Skin, skeleto Dry 30	Skin
Skin, skeleton	Skin
Skin, skeleton (part)	Skin
Skin, skull	Skin
Skin, skull, skeleton	Skin
Skin, stuffed	Skin
Skin- Feather(s)	Skin
Skin- wing(s)	Skin
Skin-Feather(s)	Skin
Skin/Nest	Skin
Skin/Skeleton	Skin
Skin/Skull	Skin
Skin/Wing	Skin
Skin; Carcass	Skin
Skin; Dry	Skin
Skin; Formalin & Alcohol	Skin
Skin; Photo; Formalin & Alcohol	Skin
Skin; Postcranial	Skin
Skin; Postcranial; Formalin & Alcohol	Skin
Skin; Skeleton	Skin
Skin; Skeleton; Formalin & Alcohol	Skin
Skin; Skull	Skin
Skin; Skull; Alcohol	Skin
Skin; Skull; Carcass	Skin
Skin; Skull; Formalin & Alcohol	Skin
Skin; Skull; Photo	Skin
Skin; Wet; Formalin & Alcohol	Skin
Skin; Wet; Skull	Skin
Skin; Wet; Skull; Formalin & Alcohol	Skin
Skinned body	Unknown
Skull	Skull
Skull	Skull
Skull (part)	Skull
Skull and spirit	Skull
Skull, Tooth (teeth)	Skull
Skull, hyoids	Skull
Skull, skeleton (part)	Skull
Skull/Skeleton	Skull
Skull; Alcohol	Skull
Skull; Baleen	Skull
Skull; Bouins & Alcohol	Skull
Skull; Death mask	Skull
Skull; Food; Formalin & Alcohol	Skull
Skull; Formalin & Alcohol	Skull
Skull; Glycol & Alcohol	Skull
Skull; Other Fixative	Skull
Skull; Photo	Skull
Skull; Photo; Formalin & Alcohol	Skull
Skull; Postcranial	Skull
Skull; Postcranial; Formalin & Alcohol	Skull
Skull; Skeleton	Skull
Skull; Skeleton; Dermestid	Skull
Skull; Skin; Formalin & Alcohol	Skull
Slide	Slide
Slide	Slide
Slide; Lactic acid - glycerol	Slide
Slides	Slide
Slides	Slide
Sloughed skin	Skin
Special Alc	Spirit
Special Alcohol	Spirit
Special Alcohol 100% (Ethanol 93% & Methanol 7%)	Spirit
Special Alcohol 75%	Spirit
Special Alcohol 75% (Ethanol 93% & Methanol 7% )	Spirit
Special Alcohol 75% (Ethanol 93% & Methanol 7%)	Spirit
Special Alcohol 75% (Methanol/Ethanol)	Spirit
Specimen	Unknown
Specimen, whole	Whole
Specimen/Lot	Unknown
Spine	Bone
Spirit	Spirit
Spirit	Spirit
Spirit & fragments	Spirit
Spirit (foetus)	Spirit
Spirit - 1	Spirit
Spirit - 1; Carpological - 1	Spirit
Spirit - 1; Photographic slide - 4; Photograph - 3; Sheet - 1; Digital image (high resolution) - 1	Spirit
Spirit - 1; Ref sheet - 1; Silica gel sample - 1; Sheet - 1	Spirit
Spirit - 1; Sheet - 1	Spirit
Spirit - 1; Sheet - 1; Carpological - 1	Spirit
Spirit - 1; Sheet - 1; Digital image (high resolution) - 1	Spirit
Spirit - 1; Sheet - 2	Spirit
Spirit - 1; Sheet - 3	Spirit
Spirit - 1; Sheet - 4	Spirit
Spirit - 1; Sheet - 7	Spirit
Spirit - 1; Silica gel sample - 1; Sheet - 1	Spirit
Spirit - 1; Silica gel sample - 1; Sheet - 2	Spirit
Spirit - 1; Wood - 1	Spirit
Spirit - 2	Spirit
Spirit - 2; Sheet - 1	Spirit
Spirit and mandible	Spirit
Spirit and skeleton	Spirit
Spirit preserved	Spirit
Spirit specimen	Spirit
Spirit specimen (gutted)	Spirit
Spirit specimen (no head)	Spirit
Spirit specimen (part)	Spirit
Spirit specimen - head only	Spirit
Spirit specimen, filleted	Spirit
Spirit, anal fin	Spirit
Spirit, baculum	Spirit
Spirit, caudal fin	Spirit
Spirit, caudal peduncle	Spirit
Spirit, clavus	Spirit
Spirit, dorsal fin 1	Spirit
Spirit, dorsal fin 2	Spirit
Spirit, egg	Spirit
Spirit, head only	Spirit
Spirit, mandible, skin	Spirit
Spirit, mount	Spirit
Spirit, pectoral fin	Spirit
Spirit, pelvic fin	Spirit
Spirit, skeleton	Spirit
Spirit, skeleton (part)	Spirit
Spirit, skeleton (part), skull	Spirit
Spirit, skeleton, skin, skull	Spirit
Spirit, skeleton, skull	Spirit
Spirit, skin	Spirit
Spirit, skin, embryo	Spirit
Spirit, skin, skull	Spirit
Spirit, skull	Spirit
Spirit, tissue	Spirit
Spleen	Tissue
Spore print - 1; Large packet - 1	Packet
Spore print - 1; Packet - 1	Packet
Spore print - 1; Packet - 1; Photograph - 1	Packet
Spore print - 1; Packet - 1; Photograph - 5	Packet
Spore print - 1; Photograph - 1; Packet - 1	Packet
Spore print - 1; Photograph - 2; Packet - 1	Packet
Spore print - 1; Photograph - 3; Packet - 1	Packet
Squamata	Unknown
Squid Beak (s)	Tissue
Squid sucker rings	Tissue
Stage	Stage
Stage	Stage
Stomach	Tissue
Stomach Contents	Tissue
Stomach contents	Tissue
Stomach contents; Formalin & Alcohol	Tissue
Swab	Unknown
T	Unknown
TADPOLE	Unknown
TADPOLE IN FORM.	Unknown
TADPOLES	Unknown
TAIL TIP ONLY	Tail
TANNED SKIN	Unknown
TBD	Unknown
TIII of tmt	Unknown
TISSUE ONLY	Tissue
TISSUES ONLY	Tissue
TOPOTYPIC	Unknown
TORSO ONLY	Unknown
Tadpole	Unknown
Tadpole, metamorphling	Unknown
Tail	Tail
Tail region	Tail
Tail tip	Tail
Tail, liver	Tail
Tail, underside	Tail
Tank	Unknown
Teeth	Teeth
Tentacle/s	Unknown
Testes	Testes
Testes (partial), Accessory Gl	Testes
Testes, Accessory Gland/s	Testes
Testis	Testes
Testis/Testes	Testes
Testis/Testes (partial)	Testes
Tissue	Tissue
Tissue Only	Tissue
Tissue, blubber	Tissue
Tissue, heart	Tissue
Tissue, liver	Tissue
Tissue, mantle	Tissue
Tissue, muscle	Tissue
Tissue, pouch folds	Tissue
Tissue, scales	Tissue
Tissue, whole specimen	Tissue
Tissue; Alcohol	Tissue
Tissue; Formalin & Alcohol	Tissue
To be vouchered (holdup/private)	Unknown
Toe	Toe
Toe Clip	Toe
Toe clip	Toe
Toe pad	Toe
Toe web	Toe
Tongue	Tongue
Tooth (teeth)	Teeth
Track	Unknown
Trypsin, etc	Unknown
Tusk	Unknown
Tylers Solution	Unknown
Tylers solution	Unknown
U	Unknown
U[U]	Unknown
Umbillical cord	Tissue
Underwing coverts	Unknown
Unfertilised ova	Unknown
Unfixed ethanol	Spirit
Unknown	Unknown
Urine	Urine
VERT & RIBS(PART)	Vertebrae
VERTEBRAE	Vertebrae
Venom crystals	Unknown
Venom gland	Tissue
Vial	Vial
Vial	Vial
Vic. Ref. Set (old) - 1	Unknown
Voucher type: morphological	Unknown
Vouchered (registered collection)	Unknown
W	Unknown
W(IC)	Unknown
W(IP)	Unknown
W(WO)	Unknown
W.	Unknown
W/Skullet; Formalin & Alcohol	Unknown
WHOLE FROGLET	Unknown
WL	Unknown
WO	Unknown
W[W]	Unknown
Ward	Unknown
Wet	Wet
Wet & Wing; Formalin & Alcohol	Wet
Wet + Skin; Formalin & Alcohol	Wet
Wet Specimen	Wet
Wet Specimen & Cast	Wet
Wet Specimen & egg case	Wet
Wet Specimen (mounted)	Wet
Wet Specimens	Wet
Wet and Dry Specimen	Wet
Wet and Dry Specimens	Wet
Wet body	Wet
Wet body; Formalin & Ethanol	Wet
Wet specimen	Wet
Wet; Alcohol	Wet
Wet; Bouins & Alcohol	Wet
Wet; Formailn & Alcohol	Wet
Wet; Formalin & Acohol	Wet
Wet; Formalin & Alcohol	Wet
Wet; Formalin & alcohol	Wet
Wet; Head	Wet
Wet; Other Fixative	Wet
Wet; Photo; Formalin & Alcohol	Wet
Wet; Skin; Formalin & Alcohol	Wet
Wet; Skull	Wet
Wet; Skull; Alcohol	Wet
Wet; Skull; Baculum	Wet
Wet; Skull; Baculum; Formalin & Alcohol	Wet
Wet; Skull; Formalin & Alcohol	Wet
Wet; Stomach contents	Wet
Wet; bac	Wet
Wet; bac; Formalin & Alcohol	Wet
Whale oil	Unknown
Whole	Whole
Whole animal (ETOH)	Whole
Whole animal (Formaldehyde)	Whole
Wing	Wings
Wing + Leg	Wings
Wing + Skull	Wings
Wing + Tail	Wings
Wing feathers	Wings
Wing(s)	Wings
Wing(s)	Wings
Wing; Formalin & Alcohol	Wings
Wings	Wings
Wings & Tail	Wings
Wood - 1	Unknown
[W]	Unknown
abdomen	Unknown
acetabulum of pelvis	Unknown
acid fuschia stain mounted in Canada balsam in xylene	Unknown
alcohol	Spirit
alcohol preserved tissue	Spirit
alcohol, sheet	Spirit
alcohol; AGA	Spirit
alcohol; gall	Spirit
alcohol; in situ on grass clipping	Spirit
alcohol; in situ on leaves	Spirit
alcohol; in situ on olives	Spirit
alcohol; in situ on stem	Spirit
alcohol; pampel's fluid	Spirit
alcohol; pampels fluid	Spirit
alizarin skeletal preparation	Unknown
ambergris	Unknown
anal swab	Unknown
and slide	Unknown
ant stern	Unknown
ant sternum frag	Unknown
ant symphysis mand	Unknown
ant tip & pt R side mand	Unknown
ant tip mand	Unknown
anterior iliac crest pelvis	Unknown
antler	Unknown
antlers	Unknown
atlas vert	Unknown
atlas vert centrum	Unknown
atlas vertebra	Unknown
axis	Unknown
axis vert	Unknown
bark	Unknown
basioccipital frag	Unknown
blood	Blood
blood lysis buffer	Blood
blubber, muscle	Tissue
body	Unknown
body fixed in 10% formalin; stored in 70% denatured ethanol	Spirit
body fixed in 10% formalin; stored in 70% undenatured ethanol	Spirit
body fixed in 10% formalin; washed and stepped up; stored in 70% denatured ethanol	Spirit
body fixed in 10% formalin; washed and stepped up; stored in 70% undenatured ethanol	Spirit
body fixed in 10% neutral buffered formalin 22 days; washed 1 day; stored in 70% undenatured ethanol	Spirit
body fixed in 10% neutral buffered formalin 3 days; washed 1 day not stepped up; stored in 70% unden	Spirit
body fixed in 10% neutral buffered formalin 3 days; washed 1 day; stored in 70% undenatured ethanol	Spirit
body fixed in 10% neutral buffered formalin 3 days; washed 1 hour not stepped up; stored in 70% unde	Spirit
body fixed in 10% neutral buffered formalin 3 days; washed 1.25 days not stepped up; stored in 70% u	Spirit
body fixed in 10% neutral buffered formalin 3 days; washed 15 minutes not stepped up; stored in 70%	Spirit
body fixed in 10% neutral buffered formalin 3 days; washed 2 hours not stepped up; stored in 70% und	Spirit
body fixed in 10% neutral buffered formalin 3 days; washed 3 hours not stepped up; stored in 70% und	Spirit
body fixed in 10% neutral buffered formalin 3 days; washed 30 minutes not stepped up; stored in 70%	Spirit
body fixed in 10% neutral buffered formalin 3 days; washed 6 hours not stepped up; stored in 70% und	Spirit
body fixed in 10% neutral buffered formalin 3 days; washed 8 days not stepped up; stored in 70% unde	Spirit
body fixed in 10% neutral buffered formalin 3 days; washed washed 4 days not stepped up; stored in 7	Spirit
body fixed in 10% neutral buffered formalin 7 days; washed 1 day; stored in 70% undenatured ethanol	Spirit
body fixed in 10% neutral buffered formalin; stored in 70% denatured ethanol	Spirit
body fixed in 10% neutral buffered formalin; stored in 70% undenatured ethanol	Spirit
body fixed in 10% neutral buffered formalin; washed and stepped up; stored in 70% denatured ethanol	Spirit
body fixed in 10% neutral buffered formalin; washed and stepped up; stored in 70% undenatured ethano	Spirit
body fixed in 10% unbuffered formalin in ANWC tapwater; staged to 70% ethanol	Spirit
body fixed in neutral buffered formalin; stored in 70% ethanol+100ml 1 Molar Formic Acid	Spirit
body in 70% ethanol; brain in 70% ethanol	Spirit
body in 70% ethanol; slides of brain sections	Spirit
body in 70% ethanol; slides of pouch young/brain sections	Spirit
body in FAA	Unknown
body in Wentworth's solution	Unknown
body in spirit	Spirit
body in spirit; puppet; skull	Unknown
body not kept	Unknown
body parts in 70% ethanol	Spirit
body parts in 70% ethanol; slides of brain sections	Spirit
body unfixed; stored in 70% denatured Ethanol	Spirit
body unfixed; stored in 70% undenatured Ethanol	Spirit
body; puppet	Unknown
body; puppet; skull	Unknown
body; skin	Unknown
body; skin; skull?	Unknown
body; skull	Unknown
bone	Bone
bone; jaws	Bone
bone; skull	Bone
bone; spirit	Bone
bones	Bone
bones; jaw	Bone
bones; jaws	Bone
bones; skin	Bone
bones; skull	Bone
bower	Unknown
boxed	Boxed
brain	Unknown
breast; foot; tail; wing	Wings
breast; head; wing	Wings
brine	Unknown
c	Unknown
c.100 frags	Unknown
c/s	Unknown
carapace	Unknown
carcass	Unknown
card	Unknown
carded/pointed	Unknown
carpometacarpus	Unknown
cast	Unknown
cast R fem	Unknown
cast R fib	Unknown
cast R tib	Unknown
cast, head	Unknown
castR tmt	Unknown
caud vert	Unknown
caudal half R pterygoid	Unknown
caudal pt cran	Unknown
caudal vert	Unknown
cedukol block in 70% ethanol; slides of brain sections	Unknown
cerv vert	Unknown
cerv vert 3	Unknown
cerv-thor vert	Unknown
cervicothoracic vert	Unknown
cf costal rib	Unknown
cleared & stained	Cleared and stained
cleared and stained	Cleared and stained
cmc	Unknown
cran pt L cor	Unknown
cran pt R cor	Unknown
cranial frag	Unknown
cranium	Head
cranium fragment	Head
cranium incomplete	Head
cranium; limb	Head
cranium; shell	Head
cranium; skin	Head
cranium; spirit	Head
crest; tail; wing	Wings
crest; wing	Wings
culture	Culture
cytological	Unknown
d rad	Unknown
d tib & several phalanges	Unknown
d tmt	Unknown
d+pR tib	Unknown
d+s L tmt	Unknown
d+s R fem	Unknown
d+sL fem	Unknown
d+sL radius	Unknown
d+sL tib	Unknown
d+sL tmt	Unknown
d+sR tib	Unknown
dL cmc	Unknown
dL fem	Unknown
dL hum	Unknown
dL hum, dR tt	Unknown
dL rad	Unknown
dL tib	Unknown
dL tib (crushed)	Unknown
dL tibia	Unknown
dL tibiotarsus	Unknown
dL tmt	Unknown
dL tmt and phalanges	Unknown
dL tmt frag (TIII & IV)	Unknown
dL tmt juv	Unknown
dL tt	Unknown
dL ulna	Unknown
dL ulna, dRdL hum, pR rad	Unknown
dL+pL ulna	Unknown
dLhum	Unknown
dR cmc	Unknown
dR fem	Unknown
dR hum	Unknown
dR hum (4 parts)	Unknown
dR humerus	Unknown
dR rad	Unknown
dR tbt	Unknown
dR tib	Unknown
dR tib frag	Unknown
dR tmt	Unknown
dR tt	Unknown
dR ulna	Unknown
dR ulna, L scap	Unknown
dRdL tib	Unknown
deformed pt tmt	Unknown
dentaries	Teeth
dentary	Teeth
dentary left	Teeth
dentary right	Teeth
dessicated	Unknown
digitised .aif	Digitized
digitised .wav	Digitized
digitised .wav and .mp3	Digitized
disarticulated skeleton	Digitized
discarded	Digitized
display mount	Digitized
dissected	Digitized
dist pt cmc	Digitized
dist tibia	Digitized
distal humerus + avian bone?	Digitized
distal pt cmc	Digitized
distal ulna	Digitized
dorsal	Digitized
dorsal vert	Digitized
dorsal-fin spine	Digitized
dried	Dry
dried body	Dry
dried specimen	Dry
dried specimen & cast	Dry
dried whole insect	Dry
dried, Dry 32	Dry
dry	Dry
dry and wet	Dry
dry phial	Dry
dry stored	Dry
drywet	Dry
e-voucher	Unknown
ear	Unknown
ear clip	Unknown
ear punch	Unknown
egg	Eggs
egg case	Eggs
egg clutch	Eggs
egg mass	Eggs
eggs	Eggs
eggs and veligers	Eggs
eggs, hatchlings	Eggs
eggs, tadpoles	Eggs
eggshell	Eggs
embryo	Embryo
embryo(s); skin	Embryo
embryos; skin; skull	Embryo
ethanol	Spirit
ethanol 100%	Spirit
ethanol 100%, absolute	Spirit
ethanol 70%	Spirit
ethanol 70% - unfixed	Spirit
ethanol 70%/dried	Spirit
ethanol 70%/glycerol	Spirit
ethanol 70%/slide	Spirit
ethanol 70%/slide/dried	Spirit
ethanol 75%	Spirit
ethanol 75-80%	Spirit
ethanol 80%	Spirit
ethanol 85%	Spirit
ethanol 90%	Spirit
ethanol 95%	Spirit
ethanol 95% - unfixed	Spirit
ethanol 95%, absolute	Spirit
ethanol 96%	Spirit
ethanol ?	Spirit
ethanol, absolute	Spirit
ethanol, skin/skull in	Spirit
ethanol, skin/skull out, skull not seen	Spirit
ethanol, whole	Spirit
ethanol, whole/skull out, skull not seen	Spirit
ethanol, whole; skull	Spirit
ethanol; skin; skull	Spirit
ethylene glycol	Spirit
eye	Eye
eye back	Eye
eye front	Eye
eye or retina back	Eye
eye or retina front	Eye
eye(s) in 70% ethanol; slides of brain sections	Eye
eye, lens	Eye
eyeskin	Eye
feather	Feather
feather base	Feather
feather time series; skin	Feather
feather(s)	Feather
feather(s); left scapular; left wing; right foot; right scapular; right wing	Feather
shell	Shell
shell and bones	Shell
shell powder	Shell
shell; skin	Shell
shell; skull	Shell
short skeleton	Skeleton
skel, skin Dry 33	Skeleton
skel, skin Dry 35	Skeleton
skel, skin, Dry 31	Skeleton
skeletal	Skeleton
skeletal (armour)	Skeleton
skeletal (femur)	Skeleton
skeletal (humerus)	Skeleton
skeletal (mandibles -lower only)	Skeleton
skeletal (mandibles)	Skeleton
skeletal (pelvic)	Skeleton
skeletal (radius bone)	Skeleton
skeletal (ribs)	Skeleton
skeletal (synsacrum)	Skeleton
skeletal (tooth)	Skeleton
skeletal (tusks)	Skeleton
skeletal (vertebrae)	Skeleton
skeletal material	Skeleton
skeletal material*	Skeleton
skeletal remains	Skeleton
skeleton	Skeleton
skeleton (no skull )	Skeleton
skeleton / skeletal remains	Skeleton
skeleton Dry 30	Skeleton
skeleton Dry 30 & 35	Skeleton
skeleton Dry 31	Skeleton
skeleton Dry 32	Skeleton
skeleton Dry 33	Skeleton
skeleton Dry 34	Skeleton
skeleton Dry 35	Skeleton
skeleton Dry 36	Skeleton
skeleton Dry 36?	Skeleton
skeleton and spirit	Skeleton
skeleton complete	Skeleton
skeleton complete, trachea in spirit	Skeleton
skeleton complete?	Skeleton
skeleton incomplete	Skeleton
skeleton, Dry 31	Skeleton
skeleton, dry 31	Skeleton
skeleton; otoliths	Skeleton
skeleton; skin	Skeleton
skeleton; skin; wing	Skeleton
skeleton; skin?	Skeleton
skeleton; skull	Skeleton
skeleton; spirit	Skeleton
skeleton; tail; wing	Skeleton
skeleton; wing	Skeleton
skeletons	Skeleton
skin	Skin
skin (head)	Skin
skin Dry 33	Skin
skin Dry 35	Skin
skin and body	Skin
skin and skeleton	Skin
skin mounted	Skin
skin only	Skin
skin skull out	Skin
skin*	Skin
skin, egg	Skin
skin, eggs	Skin
skin, nest	Skin
skin, organs, Dry 31	Skin
skin, part skeleton	Skin
skin, part skull	Skin
skin, short skeleton	Skin
skin, skeletal	Skin
skin, skull	Skin
skin, skull, short skeleton	Skin
skin, trachea in spirit	Skin
skin- head	Skin
skin/skull in	Skin
skin/skull out, skull not seen	Skin
skin; skull	Skin
skin; skull in prep	Skin
skin; skull; spirit	Skin
skin; spirit	Skin
skin; wing	Skin
skin?	Skin
skull	Skull
skull Dry 30	Skull
skull Dry 33	Skull
skull and mandible	Skull
skull and mandible and humerus	Skull
skull and quills	Skull
skull and skeleton	Skull
skull incomplete	Skull
skull only Dry 30	Skull
skull plus frags	Skull
skull*	Skull
skull, carapace	Skull
skull, mandible and ant. vertebrae	Skull
skull, mandible and skeleton	Skull
skull, part skeleton	Skull
skull, part skin (tail)	Skull
skull, skeletal	Skull
skull, skeletal (mandibles)	Skull
skull, skeleton	Skull
skull, wet	Skull
skull,skeleton and skin	Skull
skull; skeleton	Skull
skull; spirit	Skull
skull; spirit?	Skull
skull; tail	Skull
skull; whole	Skull
skull; wing	Skull
skull?	Skull
skulls	Skull
skulls, skeletal (mandibles)	Skull
slide	Slide
slide mount	Slide
slide mount of gonopods	Slide
slide mounts	Slide
slide, 2% formalin alcohol, glycerol	Slide
slide, 2% formalin alcohol, glycerol. Mounted 10 August, 1990	Slide
slide, 2% formalin alcohol, glycerol. Mounted 21 June, 2001	Slide
slide, 2% formalin alcohol, glycerol. Mounted 28 March, 1990	Slide
slide, 2% formalin alcohol, glycerol. Mounted 30 April, 2004	Slide
slide, 2% formalin alcohol, glycerol. Mounted 30 August, 1989	Slide
slide, 2% formalin alcohol, glycerol. Mounted 6 April, 1991	Slide
slide, 2% formalin alcohol, glycerol. Mounted 6 May, 1992	Slide
slide, 2% formalin alcohol, glycerol. Mounted 8 November, 1990	Slide
slide, 2% formalin alcohol, glycerol. Mounted 9 August, 1990	Slide
slide, Basic fuchsin & Sira	Slide
slide, Euparal	Slide
slide, FA 4:1, alcohol, glycerol. Mounted 10 August, 1995	Slide
slide, FA 4:1, alcohol, glycerol. Mounted 11 November, 1994	Slide
slide, FA 4:1, alcohol, glycerol. Mounted 12 June, 1995	Slide
slide, FA 4:1, alcohol, glycerol. Mounted 13 August, 2001	Slide
slide, FA 4:1, alcohol, glycerol. Mounted 13 November, 2001	Slide
slide, FA 4:1, alcohol, glycerol. Mounted 14 November, 2003	Slide
slide, FA 4:1, alcohol, glycerol. Mounted 19 January, 2001	Slide
slide, FA 4:1, alcohol, glycerol. Mounted 2 February, 2001	Slide
slide, FA 4:1, alcohol, glycerol. Mounted 20 November, 1995	Slide
slide, FA 4:1, alcohol, glycerol. Mounted 24 November, 1992	Slide
slide, FA 4:1, alcohol, glycerol. Mounted 29 August,1995	Slide
slide, FA 4:1, alcohol, glycerol. Mounted 30 September, 1996	Slide
slide, FA 4:1, alcohol, glycerol. Mounted 31 May, 1993	Slide
slide, FA 4:1, alcohol, glycerol. Mounted 5 February, 2001	Slide
slide, FA 4:1, alcohol, glycerol. Mounted 5 February, 2002	Slide
slide, FA 4:1, alcohol, glycerol. Mounted February,1998	Slide
slide, blood smear	Slide
slide, mounted 22 June, 2001	Slide
slide, mounted 7 November, 2000	Slide
slide/dried	Slide
slide; 0.1 M Buffer. FA. 4:1 alc - glycerol	Slide
slide; 1% formalin	Slide
slide; 1% formalin - glycerol	Slide
slide; 1% formalin Bakers - glycerol	Slide
slide; 2% formalin - lactophenol	Slide
slide; 2% formalin Bakers - glycerol	Slide
slide; 2% formalin alc - glycerol	Slide
slide; 4% formalin alc - glycerol	Slide
slide; ?1% formalin Bakers - glycerol	Slide
slide; ?1% formalin alc - glycerol	Slide
slide; ?FA Br2 - glycerol	Slide
slide; ?formalin alc - glycerol	Slide
slide; ?lactophenol	Slide
slide; Acid fuchsin	Slide
slide; Acid fuchsin & Euparal	Slide
slide; Acid fuchsin & Sira	Slide
slide; Acid fuchsin - alc.	Slide
slide; Acid fuchsin stain, mounted in Canada balsam in xylene	Slide
slide; Acid fuschin, Canada balsam in xylene	Slide
slide; Bakers - glycerol	Slide
slide; Bakers - glycerol; lact.	Slide
slide; Basic fuchsin	Slide
slide; Basic fuchsin & Euparal	Slide
slide; Basic fuchsin & Sira	Slide
slide; Basic fuchsin + M+W	Slide
slide; Berlese's	Slide
slide; Berlese's fluid	Slide
slide; Berlese's fluid & Picric	Slide
slide; Berlese's fluid, no potash	Slide
slide; Bovin-Borax	Slide
slide; Brzeski - glycerol	Slide
slide; Canada balsam	Slide
slide; Canada balsam in xylene	Slide
slide; Chloral acetic (warmed) & Berlese's fluid	Slide
slide; D. J. Williams method	Slide
slide; Euparal	Slide
slide; Evparal	Slide
slide; FA - Lact	Slide
slide; FA - Lactophenol	Slide
slide; FA - glycerol	Slide
slide; FA 4:1 alc - glycerol	Slide
slide; FA 4:1 alc - glycerol (6.2.81 FA)	Slide
slide; FA 4:1 processed to glycerine by Seinhorsts method	Slide
slide; FA 4:1. Alc - glycerol	Slide
slide; FA Bakers - glycerol	Slide
slide; FA Br2 - glycerol	Slide
slide; FA Br2 - glycerol x2	Slide
slide; FA Br2 - glycerol x3	Slide
slide; FA Br2 - glycerol x4	Slide
slide; FA CaCo3 - alc - glycerol	Slide
slide; FA alc - glycerol	Slide
slide; FA lactophenol, alc - glycerol	Slide
slide; FA. 4:1	Slide
slide; FA. 4:1 Bakers - glycerol	Slide
slide; FA. 4:1 alc - glycerol	Slide
slide; FA. 4:1 alc -glycerol	Slide
slide; FA. 4:1 sonicated alc - glycerol	Slide
slide; FA. Bakers - glycerol	Slide
slide; FA. Brzeski	Slide
slide; FA. Brzeski - glycerol	Slide
slide; FA. De Grine	Slide
slide; FA. Lactophenol	Slide
slide; FA. alc - glycerol	Slide
slide; FA?. glycerol	Slide
slide; Fa Lactophenol	Slide
slide; Flatters & Garnett	Slide
slide; Formalin alc - glycerol	Slide
slide; Gurr	Slide
slide; Gurr's fluid	Slide
slide; Hot FA. 4:1 alc - glycerol	Slide
slide; Hot Formalin alc - glycerol	Slide
slide; KOH & Berlese's	Slide
slide; Lactic acid & Berlese's fluid	Slide
slide; Lacto-alcohol & Berlese's fluid	Slide
slide; Pampel's fluid	Slide
slide; Sira	Slide
slide; Sira; H. A. Brand	Slide
slide; TAF - alc - glycerol	Slide
slide; TAF alc - glycerol	Slide
slide; acid fuchsin	Slide
slide; alc - glycerol	Slide
slide; alc -glycerol	Slide
slide; basic fuchsin & sira	Slide
slide; basic fuchsin sira	Slide
slide; berlese's fluid	Slide
slide; euparal	Slide
slide; formalin - Bakers - glycerol	Slide
slide; formalin - glycerol	Slide
slide; formalin - lactoph. - glycerol	Slide
slide; formalin - lactophenol - alc - glycerol	Slide
slide; formalin - lactophenol, alc - glycerol	Slide
slide; formalin -lactophenol - alc - glycerol	Slide
slide; formalin Bakers - glycerol	Slide
slide; formalin glycerol	Slide
slide; gaters fluid	Slide
slide; glycerol	Slide
slide; glycerol - formalin	Slide
slide; glycerol added 13/7/1994	Slide
slide; hot Formalin alc - glycerol	Slide
slide; lactophenol	Slide
slide; lactophenol - alc - glycerol	Slide
slide; lactophenol - cotton blue	Slide
slide; potashed	Slide
slide; sira	Slide
slides of brain sections	Slide
slides of brain/cochlear sections	Slide
slides of cochlear sections	Slide
slides of ear canal and brain	Slide
slides of head sections	Slide
slides of pouch young/brain sections	Slide
snout	Unknown
specimen dropped and disintegrated	Unknown
specimen preserved on bark	Unknown
specimen preserved on leaf	Unknown
specimen preserved on phyllode	Unknown
specimen preserved on stem	Unknown
specimen preserved on stem & leaf	Unknown
specimen preserved on stem & phyllode	Unknown
specimenForm=Dry	Dry
specimenForm=Dry;fixativeTreatment=dried;fixativeTreatment=dried	Dry
specimenForm=Dry;fixativeTreatment=painted	Dry
specimenForm=Spirit;storageMedium=ethanol 70%	Dry
specimenForm=Wet	Wet
specimenForm=Wet;fixativeTreatment=ethanol 70%	Wet
specimenForm=Wet;fixativeTreatment=ethanol 70%;storageMedium=ethanol 70%	Wet
specimenForm=Wet;fixativeTreatment=formalin 10%, unbuffered seawater;storageMedium=ethanol 70%	Wet
specimenForm=Wet;fixativeTreatment=methylated spirits 100%;storageMedium=ethanol 70%	Wet
specimenForm=Wet;storageMedium=ethanol 70%	Wet
specimenForm=Wet;storageMedium=ethanol 70%;specimenForm=Wet;storageMedium=ethanol 70%	Wet
specimenForm=Wet;storageMedium=gaw	Wet
specimenForm=frozen	Frozen
specimenForm=microslide	Microslide
specimenForm=microslide;fixativeTreatment=Slide:1	Microslide
specimenForm=microslide;fixativeTreatment=Slide:2	Microslide
specimenForm=microslide;specimenForm=Dry;specimenForm=SEM stub	Microslide
specimenForm=pinned	Pinned
specimenForm=pinned;specimenForm=pinned;specimenForm=pinned	Pinned
specimenForm=pinned;specimenForm=pinned;specimenForm=pinned;specimenForm=pinned;specimenForm=pinned	Pinned
specimenForm=spirit specimen, whole;fixativeTreatment=formalin 10%;storageMedium=ethanol 70%	Spirit
specimenNature=Baleen;specimenForm=Dry	Dry
specimenNature=Carcass;specimenForm=Wet;storageMedium=ethanol 70%	Spirit
specimenNature=Cast;specimenForm=Dry;specimenNature=skull	Dry
specimenNature=Cast;specimenForm=dry	Dry
specimenNature=Egg capsule;specimenForm=Wet;fixativeTreatment=unknown;storageMedium=ethanol 70%	Spirit
specimenNature=Mandible;specimenForm=Dry	Dry
specimenNature=Mount;specimenForm=Dry	Dry
specimenNature=Shell;specimenForm=Dry	Dry
specimenNature=Shell;specimenForm=dry	Dry
specimenNature=Skeleton (part);specimenForm=Dry	Dry
specimenNature=Skeleton, skull	Dry
specimenNature=Skeleton, skull;specimenForm=Dry	Dry
specimenNature=Skeleton;specimenForm=Dry	Dry
specimenNature=Skin, skeleton;specimenForm=Dry	Dry
specimenNature=Skin, skull, skeleton;specimenForm=Dry	Dry
specimenNature=Skin, skull;specimenForm=Dry	Dry
specimenNature=Skin;specimenForm=Dry	Dry
specimenNature=Skull (part);specimenForm=Dry	Dry
specimenNature=Skull, skeleton (part);specimenForm=Dry	Dry
specimenNature=Skull;specimenForm=Dry	Dry
specimenNature=Spirit specimen;specimenForm=Wet	Wet
specimenNature=Spirit specimen;specimenForm=Wet;fixativeTreatment=Ethanol 96%;storageMedium=ethanol 90%	Wet
specimenNature=Spirit specimen;specimenForm=Wet;fixativeTreatment=Formalin 10%;storageMedium=ethanol 70%	Wet
specimenNature=Spirit specimen;specimenForm=Wet;fixativeTreatment=ethanol 70%;storageMedium=ethanol 70%	Wet
specimenNature=Spirit specimen;specimenForm=Wet;fixativeTreatment=ethanol 95%;storageMedium=ethanol 95%	Wet
specimenNature=Spirit specimen;specimenForm=Wet;fixativeTreatment=formalin 10%;storageMedium=ethanol 70%	Wet
specimenNature=Spirit specimen;specimenForm=Wet;fixativeTreatment=unknown	Wet
specimenNature=Spirit specimen;specimenForm=Wet;fixativeTreatment=unknown;storageMedium=ethanol 70%	Wet
specimenNature=Spirit specimen;specimenForm=Wet;storageMedium=ethanol 70%	Wet
specimenNature=Spirit, skeleton, skin, skull;specimenForm=Dry	Dry
specimenNature=Spirit, skin, skull;specimenForm=Dry	Dry
specimenNature=Spirit;specimenForm=Wet	Wet
specimenNature=Spirit;specimenForm=Wet;storageMedium=ethanol 70%	Wet
specimenNature=Tissue;specimenForm=frozen	Frozen
specimenNature=Tissue;specimenForm=frozen;fixativeTreatment=ethanol 70%;storageMedium=ethanol 70%	Frozen
specimenNature=Whole	Whole
specimenNature=Whole;specimenForm=Dry	Whole
specimenNature=Whole;specimenForm=Wet;fixativeTreatment=formalin 10%;storageMedium=ethanol 70%	Whole
specimenNature=Whole;specimenForm=frozen	Whole
specimenNature=microslide;specimenForm=microslide	Microslide
specimenNature=microslide;specimenForm=microslide;specimenForm=Dry	Unknown
specimenNature=partial;specimenForm=Wet	Unknown
specimenNature=whole;specimenForm=frozen	Unknown
specimens in phial	Unknown
specimens preserved on bark	Unknown
specimens preserved on branch segments	Unknown
specimens preserved on leaves	Unknown
specimens preserved on leaves & stems	Unknown
specimens preserved on stem	Unknown
specimens preserved on stem & leaf	Unknown
specimens preserved on stems	Unknown
spine	Bone
spirit	Spirit
spirit & mummified body	Spirit
spirit & mummified body & bones	Spirit
spirit & mummified skin	Spirit
spirit & part skull & skeleton	Spirit
spirit & skeleton	Spirit
spirit & skull & bones	Spirit
spirit & skull & mandible	Spirit
spirit & skull & mandible & claw	Spirit
spirit & skull & mandible & skin	Spirit
spirit & skull & mummified	Spirit
spirit & skull & rib & bones	Spirit
spirit & skull & vertebrae	Spirit
spirit & skull part	Spirit
spirit and skull	Spirit
spirit skull removed	Spirit
spirit specimen	Spirit
spirit specimen + 1 microslide	Spirit
spirit specimen + 1 slide	Spirit
spirit specimen + 4 microslides	Spirit
spirit specimens + 1 microslide	Spirit
spirit(pe)	Spirit
spirit, embryo	Spirit
spirit, filleted	Spirit
spirit, specimen & eggs	Spirit
spirit, whole	Spirit
spirit; wing	Spirit
spirit?	Spirit
stage	Stage
stern part R cor	Unknown
stern pt L cor	Unknown
stern pt R cor	Unknown
sternal end L cor	Unknown
sternal end coracoid	Unknown
sternal pt R cor	Unknown
sternum	Unknown
sternum complete	Unknown
sternum fragment	Unknown
sternum incomplete	Unknown
stomach + intestine	Tissue
stomach contents	Tissue
storageMedium=ethanol 70%	Spirit
stored dry	Dry
stored dry in spirit collection	Dry
stored dry, in situ with coffee beans	Dry
stored dry; with alcohol specimens	Dry
stuffed specimen	Unknown
swim bladder	Unknown
syn	Unknown
synsacrum	Unknown
synsacrum complete	Unknown
syrinx	Unknown
tail	Tail
tail tip	Tail
tail, wings	Tail
tail; wing	Tail
tail; wings	Tail
tarsometatarsus	Unknown
teeth	Teeth
testes	Testes
testes and ovary	Testes
thor vert	Unknown
thoracic vert	Unknown
tibia	Unknown
tibiotarsus	Unknown
tibiotarsus frag	Unknown
tissue	Tissue
tissue (ETOH)	Tissue
tissue liver	Tissue
tissue or blood	Tissue
tissue sample	Tissue
tissue, gill arch	Tissue
tissue, gill arch, muscle	Tissue
tissue, liver	Tissue
tissue, muscle	Tissue
tissue, ovary	Tissue
tissue, scales	Tissue
tissue, tail tip	Tissue
tissue, whole specimen	Tissue
tissue; type not recorded	Tissue
tissues	Tissue
tissues: heart	Tissue
tissues: heart, muscle	Tissue
tissues: liver	Tissue
tissues: liver, heart, muscle	Tissue
tissues: muscle	Tissue
tmt	Unknown
tmt (-prox)	Unknown
tmt TIII	Unknown
to be mounted	Unknown
toe	Toe
toe bone	Toe
toe clip	Toe
toepad	Toe
tongue	Tongue
tooth (fossil)	Teeth
tooth/teeth	Teeth
trachea	Unknown
transparency	Unknown
treated with vinegar, returned to alcohol	Unknown
trochlea 2 R tmt	Unknown
ulna + frags	Unknown
ulnare	Unknown
unfixed ethanol	Spirit
ungual	Unknown
ungual of digit 3	Unknown
ungual phal	Unknown
ungul phal	Unknown
unknown	Unknown
unsighted	Unknown
urine	Urine
ventral fin	Unknown
vert	Vertebrae
vert frag	Vertebrae
vert pt	Vertebrae
vertebra	Vertebrae
vertebrae	Vertebrae
vertical	Unknown
vial	Unknown
vial and slide	Unknown
vomeropalatine frag	Unknown
vouchered	Unknown
water	Unknown
wet	Wet
wet (in ethanal or some other preservative)	Wet
wet (in ethanol or some other preservative)	Wet
wet and slide (both preserved in ethanol, others on a slide)	Wet
wet, dry	Wet
wetdry	Wet
whole	Whole
whole animal	Whole
whole animal (ETOH)	Whole
whole animal (ETOH); alizarin skeletal preparation	Whole
whole animal (ETOH); otoliths	Whole
whole animal (ETOH); skeleton	Whole
whole animal (ETOH); skin	Whole
whole animal (ETOH); tissue (ETOH)	Whole
whole animal (Koenikes fluid)	Whole
whole animal (slide)	Whole
whole animal in 95% ethanol	Whole
whole animal; tissue	Whole
whole animal; tissue (ETOH)	Whole
whole naimal (slide)	Whole
whole/skull not seen	Whole
whole/skull out	Skull
wing	Wings
wing punch	Wings
wings	Wings
wood	Unknown
yolk	Unknown